start_station_name,Avg_ride_length,Avg_ride_length_Casual,Avg_ride_length_Member,Casual_riders,Member_riders,Electric_bike_riders,Classic_bike_riders,Total_riders
Streeter Dr & Grand Ave,32.08785332758265,35.5620081288465,20.805723478710174,46091,14193,12811,47473,60284
DuSable Lake Shore Dr & Monroe St,32.335509371840118,35.013777763203777,23.6400475531424,30496,9393,8573,31316,39889
Michigan Ave & Oak St,31.694449104754447,38.354640913957141,20.080247813411059,22729,13034,9093,26670,35763
DuSable Lake Shore Dr & North Blvd,24.005748629270421,28.42358556028918,17.884959867641474,20656,14909,7375,28190,35565
Kingsbury St & Kinzie St,10.448408066853242,14.266959698137448,9.1941855865833375,8304,25282,10751,22835,33586
Clark St & Elm St,13.733412854931403,18.742178040480042,11.627663067214886,9305,22133,9593,21845,31438
Clinton St & Washington Blvd,12.565736227551385,16.535275080906157,11.670143507640029,5665,25109,12598,18176,30774
Millennium Park,32.4320539334244,39.379590631081527,18.169716425896173,19184,9345,7151,21378,28529
Clinton St & Madison St,12.719182265655869,18.989394183301133,10.917667237099721,6212,21621,11009,16824,27833
Wells St & Concord Ln,13.815490003516052,18.289806985622054,11.51226446280992,9343,18150,9255,18238,27493
Theater on the Lake,26.559551385427334,30.956937783325678,21.010963276133662,15221,12063,5244,22040,27284
Wells St & Elm St,12.106819206492343,16.184676284306825,10.184883913764525,8526,18090,9168,17448,26616
Shedd Aquarium,28.044884350906411,30.023440687342259,19.950141452719389,19282,4713,5506,18489,23995
Indiana Ave & Roosevelt Rd,22.219365392968712,30.970399329796123,15.013144514282788,10743,13046,6009,17780,23789
Dearborn St & Erie St,16.245367164851235,24.417212688507547,12.781605049594221,7051,16635,7092,16594,23686
Wabash Ave & Grand Ave,19.765344788185228,30.824018827193289,12.281929975812442,9419,13919,7274,16064,23338
University Ave & 57th St,9.9165846923807131,15.987802460497932,7.9287746024473575,5717,17461,3622,19556,23178
Dusable Harbor,31.723437522768691,35.045216360403067,22.391479322786559,16870,6005,5235,17640,22875
State St & Chicago Ave,13.504586761187925,19.874430836866054,11.043291067564574,6369,16483,7412,15440,22852
Clinton St & Jackson Blvd,13.006691834074887,19.178516283897746,11.153665829096788,5138,17113,8940,13311,22251
Michigan Ave & Washington St,21.295983498798723,32.1786399396487,13.39456181533647,9279,12780,6132,15927,22059
Broadway & Barry Ave,15.424341634300514,21.412921119592859,12.866454733181168,6550,15335,6608,15277,21885
Clark St & Lincoln Ave,18.33252235725751,25.94234060072321,12.661398804759612,9311,12494,6025,15780,21805
Clark St & Armitage Ave,18.089703424268912,25.519543304221212,12.6784500808354,9160,12577,6044,15693,21737
Wilton Ave & Belmont Ave,13.330724058321319,18.18057510148849,10.792991338006567,7390,14123,6665,14848,21513
Wells St & Huron St,11.861313447722342,15.946454519035171,9.9233565405206754,6882,14507,6990,14399,21389
Desplaines St & Kinzie St,10.801003648206425,14.053495125492644,9.3941659376892588,6428,14861,7359,13930,21289
Wells St & Hubbard St,12.538096148636811,17.080343492255079,10.431454528491132,6628,14291,7202,13717,20919
Ellis Ave & 60th St,8.4870545554000341,11.731174320310714,7.2149533024255925,5836,14883,2710,18009,20719
LaSalle St & Illinois St,17.547777832342977,25.03832240111311,12.304146490788675,8385,11978,6611,13752,20363
Sheffield Ave & Fullerton Ave,11.810846143739335,15.445126856435651,10.11246626180837,6464,13832,5905,14391,20296
Larrabee St & Kingsbury St,10.629394514978822,13.461247540338459,9.86895462135143,4235,15771,7643,12363,20006
Canal St & Adams St,14.54129829154499,20.525806090461256,12.805340131635909,4466,15396,8471,11391,19862
Canal St & Madison St,13.757625630897509,18.528446551835373,12.06689643347052,5167,14580,7843,11904,19747
McClurg Ct & Ohio St,22.385787336697021,34.482834658923515,14.195982905982913,7921,11700,5327,14294,19621
Wabash Ave & Roosevelt Rd,16.375225959904871,26.751858099473491,11.209486729266873,6521,13099,6036,13584,19620
Columbus Dr & Randolph St,21.251624127956429,32.470683483183471,13.494567720025326,8008,11582,6405,13185,19590
New St & Illinois St,22.59125799391267,32.557740916271754,14.283980749937257,8862,10632,5757,13737,19494
Michigan Ave & Lake St,19.550502090616195,30.350532366166121,12.23062647346328,7858,11594,5691,13761,19452
Dearborn Pkwy & Delaware Pl,14.755674908089812,20.288344838657892,12.084538572831089,6229,12902,6088,13043,19131
Kingsbury St & Erie St,9.9876414527194388,13.360455324539828,8.9384310452743616,4473,14379,6148,12704,18852
DuSable Lake Shore Dr & Diversey Pkwy,21.866306889728413,28.844550911039665,16.82159770649309,7775,10755,4979,13551,18530
Daley Center Plaza,15.629218406939493,22.068763461294846,13.073797134238312,5262,13260,5716,12806,18522
Michigan Ave & 8th St,26.831181714409986,33.593822706935114,14.385499974267923,11920,6477,4140,14257,18397
Ashland Ave & Division St,14.052765390472029,18.309484183191692,12.165642333856635,5648,12740,7051,11337,18388
Clark St & Wrightwood Ave,14.199664578366692,19.46188307386554,11.551670972581046,6038,11999,5413,12624,18037
Morgan St & Polk St,9.5599557235221067,12.718438991138381,9.0632685875996977,2445,15548,6555,11438,17993
Loomis St & Lexington St,10.487706137170688,15.065581046019393,9.76620609504132,2441,15488,5234,12695,17929
Ellis Ave & 55th St,8.9348910443298255,13.126072880071641,7.3744441024851879,4839,12997,2331,15505,17836
Halsted St & Fulton St,13.993847793169218,17.684949994317538,12.184235966011967,5866,11965,7404,10427,17831
Montrose Harbor,30.159849972875371,35.885175497003736,21.92136828177755,10513,7306,4231,13588,17819
Dearborn St & Monroe St,14.790887093737064,21.62908655467854,12.143167985790031,4941,12761,6285,11417,17702
Halsted St & Clybourn Ave,13.324235356580779,16.872596333707456,11.773549688002415,5346,12233,5945,11634,17579
Clinton St & Lake St,11.342168421855925,15.403638763197581,9.9667700990908212,4420,13052,6455,11017,17472
Broadway & Waveland Ave,13.389845733814461,20.323560590313889,10.752424625764272,4811,12648,5852,11607,17459
Green St & Madison St,13.212868083476939,17.931518969909785,11.395461054976517,4841,12569,6333,11077,17410
Adler Planetarium,30.23382934223654,33.952337078046341,21.030169367206788,12373,4999,3870,13502,17372
Broadway & Cornelia Ave,15.80936083627458,22.94387900355872,12.371481036897304,5620,11663,5597,11686,17283
Orleans St & Merchandise Mart Plaza,12.844875290023193,17.883423692902095,10.578354778123506,5349,11891,7203,10037,17240
Lincoln Ave & Fullerton Ave,13.913798513463158,18.281714338781587,11.888752547432471,5384,11613,5583,11414,16997
Clark St & Drummond Pl,15.330398259503227,21.159205983889542,12.648724962498884,5214,11333,4515,12032,16547
Clark St & Lake St,16.338200366942889,26.38892483660133,11.854801889267906,5100,11433,5252,11281,16533
State St & 33rd St,8.7802315011211522,20.341791666666666,7.87350173191295,1200,15301,4630,11871,16501
Pine Grove Ave & Waveland Ave,17.775005570748498,26.603508248857096,13.887033146591993,5031,11424,4452,12003,16455
Damen Ave & Pierce Ave,14.741211586799629,19.080034784694725,12.525964541613066,5558,10886,6278,10166,16444
St. Clair St & Erie St,17.110243066185028,28.135014251260674,12.838752973156659,4561,11772,6656,9677,16333
Sheffield Ave & Waveland Ave,16.157442139692797,22.309205152371987,12.135038345658723,6366,9736,5946,10156,16102
Larrabee St & Webster Ave,14.500379166666669,18.938591916558025,11.739544471478764,6136,9864,4639,11361,16000
Clark St & Schiller St,15.50535208333333,20.870393354974219,12.894860478800826,5237,10763,4859,11141,16000
DuSable Lake Shore Dr & Belmont Ave,23.819530056702856,32.142414956290388,17.269517666853631,7016,8915,4374,11557,15931
Fairbanks Ct & Grand Ave,19.146525973340086,29.159069363248516,12.440770723104059,6329,9450,4672,11107,15779
Wells St & Evergreen Ave,13.883996000595648,17.365294399234077,11.563500673615552,6267,9402,5070,10599,15669
Clark St & Newport St,15.063503377442517,19.305600242828966,11.976340107503129,6589,9054,5846,9797,15643
Federal St & Polk St,14.856455256484029,21.506895431208154,11.611582001522077,5129,10512,4387,11254,15641
Peoria St & Jackson Blvd,11.908783986298429,17.477761958997725,10.286769502957926,3512,12058,5021,10549,15570
Franklin St & Jackson Blvd,15.653815597354606,24.011893219572094,11.496141603163888,5157,10367,5246,10278,15524
Lakeview Ave & Fullerton Pkwy,19.361884435755393,26.238525827671726,14.722421695951116,6182,9163,4367,10978,15345
Halsted St & Polk St,9.83145299702363,13.926319988395704,9.110103487926402,2298,13045,5794,9549,15343
Ravenswood Ave & Lawrence Ave,11.431957446808504,15.243750511247443,10.045077380952383,4075,11200,6690,8585,15275
Southport Ave & Waveland Ave,13.588589188952989,18.857344632768378,11.270734623249961,4661,10595,4887,10369,15256
State St & Randolph St,17.423740522138988,25.24649500516707,12.525766562421374,5806,9273,4240,10839,15079
DuSable Lake Shore Dr & Wellington Ave,22.384536938612783,28.66699605768234,17.70437437205349,6426,8626,3652,11400,15052
McClurg Ct & Erie St,21.213814273049618,35.931038158175205,14.542783521757322,4691,10349,4367,10673,15040
Halsted St & Roscoe St,15.473996050763215,20.162124266862175,12.800665412486069,5456,9568,5835,9189,15024
LaSalle St & Jackson Blvd,14.165358681189803,21.523466131356809,12.101289381732078,3238,11543,5521,9260,14781
Southport Ave & Roscoe St,14.659242033315234,19.75495504495505,12.036178819980114,5005,9723,4320,10408,14728
MLK Jr Dr & 29th St,12.461194622046882,24.724915946205563,11.182687396725248,1388,13314,4991,9711,14702
Halsted St & Wrightwood Ave,12.68687656001816,15.279842298128518,11.310410587744885,5094,9596,4352,10338,14690
Sheridan Rd & Irving Park Rd,13.020682689438285,18.14379567842392,10.938689265536725,4196,10325,4333,10188,14521
Sedgwick St & Huron St,10.883172119487897,15.852331920048449,9.3579661647146271,3302,10758,4298,9762,14060
Aberdeen St & Jackson Blvd,11.919150424432113,15.617749632892806,10.630706886629577,3632,10426,4742,9316,14058
Franklin St & Lake St,13.379624486695635,18.445872073002754,11.450953691869042,3872,10171,5516,8527,14043
Sheffield Ave & Wrightwood Ave,13.220854483925544,17.207780555021479,10.806603407459155,5201,8589,3921,9869,13790
Kimbark Ave & 53rd St,12.13898872317206,18.06239214650466,9.8871556715868412,3786,9959,2427,11318,13745
Rush St & Cedar St,16.436479089117579,23.801872855842589,12.514036167039528,4761,8940,4894,8807,13701
Sheffield Ave & Webster Ave,13.8553888848138,18.558074921193452,11.501975566806077,4547,9086,4146,9487,13633
Stockton Dr & Wrightwood Ave,19.361157621600455,25.651131492687849,15.367715211910221,5288,8329,3472,10145,13617
Sheffield Ave & Wellington Ave,14.117404021039189,18.632992624659284,12.120826244151427,4158,9404,3964,9598,13562
State St & Kinzie St,17.695749655443979,27.34669473965641,12.071200966070666,4987,8557,4985,8559,13544
Rush St & Superior St,17.238051411464895,26.679132587171761,12.268836146671211,4646,8827,4468,9005,13473
Milwaukee Ave & Grand Ave,12.0692640366096,16.128574090638043,10.002874217416052,4472,8785,5024,8233,13257
Pine Grove Ave & Irving Park Rd,14.907364104907719,23.692429691101882,11.569334664704654,3615,9514,4196,8933,13129
Franklin St & Monroe St,12.710187609075046,18.682513440860202,11.300655056464906,2480,10508,6309,6679,12988
Cityfront Plaza Dr & Pioneer Ct,22.222571215165122,32.638663268661638,12.98777939747327,6082,6860,3762,9180,12942
Broadway & Belmont Ave,16.086751178789527,23.05821124763705,12.697524411257897,4232,8705,3973,8964,12937
Calumet Ave & 33rd St,8.8793604575924583,20.083165195460275,8.1442440289039748,793,12086,3291,9588,12879
Wabash Ave & 9th St,16.631607806449949,23.752300739523424,12.276345437031447,4868,7959,4235,8592,12827
Racine Ave & Fullerton Ave,12.988403924945839,15.858633093525178,12.138170624450291,2919,9854,3307,9466,12773
Franklin St & Illinois St,11.762531328320797,15.370425334009804,10.151119797567784,3942,8826,4028,8740,12768
Sedgwick St & North Ave,13.910978366585178,18.458460788723947,11.455834851244687,4446,8235,3186,9495,12681
Mies van der Rohe Way & Chicago Ave,18.576215731285785,29.075327315605435,13.533345051167881,4099,8534,4297,8336,12633
Clark St & Wellington Ave,14.223180137348123,18.428040127232688,12.209203484511118,4087,8533,3418,9202,12620
Canal St & Monroe St,13.152907146458615,20.811412726211334,10.900173432241228,2855,9706,5401,7160,12561
Mies van der Rohe Way & Chestnut St,21.760641302320646,31.831552917903089,14.132834667790409,5392,7119,4081,8430,12511
Broadway & Sheridan Rd,13.64637552470132,18.374631188342832,11.645896994064721,3683,8705,4373,8015,12388
Clark St & Winnemac Ave,13.904621415588299,18.360228951255539,11.704174265450868,4062,8225,5282,7005,12287
Sheridan Rd & Montrose Ave,13.540231447162496,17.816726239574741,11.71125548761367,3637,8504,4212,7929,12141
Bissell St & Armitage Ave*,12.634393023705057,16.507483829826008,10.951300475059403,3659,8420,3492,8587,12079
Wabash Ave & Wacker Pl,21.756530561537193,30.034646293152203,13.871973372143156,5890,6184,3697,8377,12074
Sedgwick St & Webster Ave,14.560019052352562,19.065045789772267,12.231940779829952,4113,7959,3571,8501,12072
Clarendon Ave & Gordon Ter,15.960393002238598,20.565223620919046,14.256856731788586,3257,8804,4190,7871,12061
Lincoln Park Conservatory,26.014325710325753,33.324565933795753,16.57425368394307,6777,5248,2858,9167,12025
Halsted St & Dickens Ave,14.458795214245971,18.410913140311795,12.447142797161701,4041,7939,4093,7887,11980
Desplaines St & Jackson Blvd,12.185136951772803,17.235543910372243,10.655363984674331,2767,9135,4169,7733,11902
Buckingham Fountain,29.943767944603952,34.284788831883439,16.410529670839132,8966,2876,2738,9104,11842
Michigan Ave & 14th St,17.338550354609911,25.870272904483404,13.045949000042635,3933,7817,3519,8231,11750
Sheffield Ave & Kingsbury St,13.256485034535675,17.281732610082972,11.788414988944497,3134,8593,4083,7644,11727
Wilton Ave & Diversey Pkwy,12.372903666980079,16.653426791277262,10.441066038125951,3638,8061,3763,7936,11699
Michigan Ave & Jackson Blvd,24.924548390784871,34.438290625163759,13.508416650946353,6361,5301,2769,8893,11662
Ogden Ave & Chicago Ave,12.986526379206477,16.319376867264193,11.299362630714713,3905,7714,4577,7042,11619
900 W Harrison St,10.939624685286033,16.393362369337982,9.1016459214028451,2870,8516,3463,7923,11386
Field Blvd & South Water St,23.445130641330177,31.188677782086085,17.012336930262528,5158,6209,4518,6849,11367
Lakefront Trail & Bryn Mawr Ave,30.101003641531126,37.630676982591893,23.707768106421433,5170,6089,3355,7904,11259
Southport Ave & Wellington Ave,12.926292742706842,15.877647955295929,11.315830445830446,3937,7215,3471,7681,11152
Canal St & Jackson Blvd,13.790407414094002,20.2220492118416,11.816985175573111,2601,8477,4724,6354,11078
Field Museum,27.471839132811077,29.169287883901497,20.248946864528492,8889,2089,2719,8259,10978
Franklin St & Chicago Ave,11.913018982536078,17.513497055006493,9.46409332984111,3339,7636,3592,7383,10975
Wells St & Walton St,11.463471901462663,14.991617357001976,9.6177360348951755,3718,7107,2534,8291,10825
Clark St & North Ave,20.779339008667218,29.440486065633408,14.40659331834244,4581,6226,2668,8139,10807
Wood St & Milwaukee Ave,15.948891060239491,21.046312187148846,13.726134794422899,3263,7483,4663,6083,10746
Clark St & Grace St,14.857750202152157,18.255037208649252,12.155854271356789,4748,5970,4022,6696,10718
Clark St & Chicago Ave,13.035933151986994,18.569161829106822,10.584625970041511,3273,7388,2876,7785,10661
Shore Dr & 55th St,24.19383232969518,34.086713646039847,16.81358359345052,4541,6087,2190,8438,10628
Burling St & Diversey Pkwy,13.725090179103544,18.588039579468152,12.072839973104728,2695,7932,2734,7893,10627
Dayton St & North Ave,13.924731488501378,16.299631226053648,12.756087386877844,3480,7072,3434,7118,10552
LaSalle Dr & Huron St,15.569182990922123,22.993920013643731,11.142200528777705,3909,6556,2981,7484,10465
Wabash Ave & Adams St,18.269826209187915,29.831691715870456,11.847716656728274,3726,6708,3635,6799,10434
Broadway & Wilson Ave,14.919227080935949,20.650641968048614,12.145277738247716,3401,7027,3351,7077,10428
Racine Ave & Belmont Ave,14.094993717985885,17.832276269819939,11.9962269846061,3721,6626,3276,7071,10347
May St & Taylor St,10.696249635178523,15.644881507381511,9.7045583712873231,1716,8563,2993,7286,10279
Milwaukee Ave & Wabansia Ave,15.410390665626608,22.183221797323139,12.42455980144236,3138,7118,3502,6754,10256
Honore St & Division St,14.375260264168144,17.45379149613461,13.141153951326229,2932,7314,4047,6199,10246
Sangamon St & Lake St,14.369617502653936,21.163412408759125,11.822409231891985,2740,7308,3578,6470,10048
California Ave & Milwaukee Ave,14.473153126244519,19.07454158915758,11.716422544180865,3763,6281,3849,6195,10044
Aberdeen St & Randolph St,13.599313246200408,18.898105369807503,11.010121788207332,3290,6733,3805,6218,10023
Woodlawn Ave & 55th St,11.557452738323086,16.92777404169469,9.2604103744187185,2974,6953,1467,8460,9927
Morgan St & Lake St*,12.865391216557299,17.713287535586076,11.055160380846745,2693,7212,3653,6252,9905
Lincoln Ave & Diversey Pkwy,13.0613542930314,15.255480787985174,11.902947688188641,3418,6474,3467,6425,9892
Southport Ave & Belmont Ave,13.220647118301324,17.103561718325178,11.476891330891323,3065,6825,3032,6858,9890
Stetson Ave & South Water St,18.056186561104337,28.983489805595095,11.995042343906169,3515,6337,4017,5835,9852
Ritchie Ct & Banks St,16.682786913151538,22.004446460980027,13.223797887877781,3857,5934,3252,6539,9791
Wells St & Polk St,13.019057349135005,17.635000517759131,10.757111686202876,3219,6569,3738,6050,9788
Franklin St & Adams St (Temp),14.755862517544765,24.934450450450452,10.698755146988407,2775,6962,3632,6105,9737
Burnham Harbor,29.328022034596373,35.092754736303078,25.4497847054771,3906,5806,1524,8188,9712
Rush St & Hubbard St,16.833208955223878,26.904448381064842,11.384991747857097,3387,6261,3794,5854,9648
Halsted St & Maxwell St,11.590237749671711,16.719210778279297,9.85639016044759,2437,7209,3932,5714,9646
Michigan Ave & Madison St,22.184971591899327,32.901000545043985,13.499753881105637,4281,5282,3164,6399,9563
Clarendon Ave & Junior Ter,18.610157150340481,27.516249050873192,14.381414812525769,3073,6472,2960,6585,9545
Michigan Ave & Pearson St,25.105450369902897,35.758103722118634,14.118194444444439,4827,4680,2324,7183,9507
Elizabeth St & Randolph St,11.244987191634211,14.930091494408675,9.5842140093667254,2951,6548,3941,5558,9499
Financial Pl & Ida B Wells Dr,13.753541425006141,20.756767208043311,11.127712532018757,2586,6897,2841,6642,9483
Damen Ave & Cortland St,16.984939157120923,22.430150947024305,13.771022017932143,3467,5874,3463,5878,9341
Clifton Ave & Armitage Ave,13.952817758682432,16.68689604685213,12.817289956420401,2732,6578,2836,6474,9310
Southport Ave & Wrightwood Ave,12.836015325670504,16.651962741184303,11.016129885239829,3006,6303,2991,6318,9309
Aberdeen St & Monroe St,13.889046058620059,24.888107526881711,10.144856027330412,2325,6830,2852,6303,9155
Sheridan Rd & Buena Ave,13.322745033596252,15.89069177350428,12.356280156815442,2496,6632,3244,5884,9128
Clark St & Berwyn Ave,16.516345051938927,22.129261796042616,13.624528090516991,3066,5951,3891,5126,9017
Carpenter St & Huron St,11.750927578258615,15.161656058904283,10.303738416732859,2671,6295,3750,5216,8966
Lake Park Ave & 56th St,14.024525334232111,19.545385572139306,11.646144778438627,2680,6221,1501,7400,8901
Dearborn St & Adams St,16.720852582159615,26.388897031879807,12.427963987417293,2729,6146,2493,6382,8875
Elston Ave & Cortland St,12.7856146091928,14.138660302830809,12.079819139194152,3038,5824,3445,5417,8862
Blackstone Ave & 59th St,10.16118584671038,16.057901026289894,8.0019407979408044,2371,6475,1347,7499,8846
Kedzie Ave & Milwaukee Ave,18.327575379260775,22.402965235173806,15.530570972886762,3586,5225,3283,5528,8811
Larrabee St & Division St,11.04160505061995,13.465358808142836,9.82931456200228,2931,5860,2559,6232,8791
Clark St & Leland Ave,13.956343753578379,15.210830113569839,13.349561105447954,2847,5886,2979,5754,8733
Michigan Ave & 18th St,19.872057306590239,29.591435477091203,14.320127258538921,3172,5553,2610,6115,8725
Halsted St & Willow St,13.998885172798222,18.727910409446803,11.976942706618365,2597,6074,2919,5752,8671
Larrabee St & Oak St,11.973432133070897,14.348981861738533,11.28161409278915,1948,6689,2783,5854,8637
Wacker Dr & Washington St,12.103627747999688,19.249779922126283,9.9758833610565016,1969,6613,4095,4487,8582
Damen Ave & Chicago Ave,13.735420108567387,17.073860247123985,12.45660192590174,2347,6127,3949,4525,8474
Jefferson St & Monroe St,12.769414712367212,15.290282634032637,11.812430175322158,2288,6027,2729,5586,8315
Lincoln Ave & Melrose St,13.978689444979135,20.086672683513839,11.758333333333326,2216,6096,2894,5418,8312
Rhodes Ave & 32nd St,12.375801532843791,32.927027027027037,10.798831281054232,592,7715,2724,5583,8307
State St & Pearson St,14.962772679707008,22.14316536345207,12.198681716833892,2302,5980,1871,6411,8282
Western Ave & Winnebago Ave,15.385069949862526,20.954833458552461,12.72890541024722,2662,5582,2943,5301,8244
Greenview Ave & Fullerton Ave,13.643081799341703,16.574779579067105,12.470202537406834,2344,5859,2720,5483,8203
Sheffield Ave & Willow St,12.392327518660572,15.868610988363534,11.040638602520049,2263,5820,2256,5827,8083
Calumet Ave & 18th St,22.833134822167082,31.7890231191965,15.896363569646258,3518,4542,2385,5675,8060
Wabash Ave & 16th St,18.460941523382328,28.840685553102805,13.145918111027374,2718,5308,2049,5977,8026
State St & Harrison St,19.032471769134261,28.202168883747824,12.004809397163125,3458,4512,1943,6027,7970
State St & Van Buren St,18.154271187865049,26.56430340223945,12.771294190614014,3096,4837,2288,5645,7933
Ogden Ave & Race Ave,13.377714694255188,17.427162629757788,11.710040375252349,2312,5614,3043,4883,7926
Ellis Ave & 58th St,10.330677493022081,18.323868686868689,8.2143800813008152,1650,6232,1150,6732,7882
Wolcott Ave & Polk St,12.717900135639196,15.507854565639748,12.215013257291512,1201,6663,2859,5005,7864
Desplaines St & Randolph St,13.739826508483221,18.152810038713117,11.677074753525511,2497,5342,2708,5131,7839
Orleans St & Chestnut St (NEXT Apts),10.645419781730684,14.801899191218949,8.885207951070333,2308,5450,2682,5076,7758
Halsted St & Roosevelt Rd,11.238771634511632,15.093448202510098,10.25756985055231,1567,6156,2172,5551,7723
Green St & Randolph St*,14.576217010064365,17.807202982202973,12.7650353892821,2772,4945,2727,4990,7717
Paulina St & Flournoy St,13.43833902909218,16.161556329849017,12.954398864809091,1148,6460,3413,4195,7608
Clark St & Ida B Wells Dr,16.071743421052634,23.945903089696493,12.328039862809812,2449,5151,1993,5607,7600
LaSalle St & Washington St,15.295644090305448,22.7876978530011,12.346245912764532,2127,5403,2977,4553,7530
Orleans St & Hubbard St,11.913824976725625,16.732522606797627,9.9992411571578987,2138,5381,2324,5195,7519
Cornell Ave & Hyde Park Blvd,20.770027992535315,32.964696463380641,15.054672409292619,2394,5108,1361,6141,7502
Damen Ave & Division St,13.943158415396381,18.408031529612263,11.874651269903941,2347,5066,3133,4280,7413
Eckhart Park,13.354475813784319,17.739947089947087,11.468389571549313,2205,5127,2579,4753,7332
Lincoln Ave & Roscoe St*,14.874164846167842,17.682514734774077,13.792886409480582,2036,5288,2492,4832,7324
Southport Ave & Irving Park Rd,11.177344570828202,15.500567437800088,9.1988180849647154,2291,5006,2495,4802,7297
Woodlawn Ave & 58th St,12.1453767914933,20.609275942609273,8.9007738552059248,1998,5212,1355,5855,7210
Racine Ave & Congress Pkwy,10.815576478361409,16.889498703543644,9.6256800993340068,1157,5906,2164,4899,7063
McCormick Place,28.73896473265075,35.283907804399647,15.044664321313402,4758,2274,1903,5129,7032
Sangamon St & Washington Blvd,12.8273283610633,16.786531766753694,10.880762373413205,2298,4674,2523,4449,6972
Wells St & Randolph St,17.3757049164632,23.989412997903564,13.930162370758694,2385,4578,2110,4853,6963
Damen Ave & Thomas St (Augusta Blvd),14.384695247686192,16.765936522127845,13.254691698486774,2237,4714,2337,4614,6951
Larrabee St & Armitage Ave,14.18756294058409,18.600645205107316,11.779356608109104,2454,4497,2015,4936,6951
Lakefront Trail & Wilson Ave,32.714282959749291,41.399467316720838,22.765260109628734,3692,3223,1549,5366,6915
Broadway & Argyle St,16.461193559338486,22.541970377766678,13.960208761122518,2003,4870,2059,4814,6873
Wood St & Chicago Ave,12.852584973607602,17.398772940674341,11.485665704202756,1562,5195,2817,3940,6757
Green St & Washington Blvd,14.867148647980612,19.043737208350404,12.494263565891471,2443,4300,2468,4275,6743
Throop St & Taylor St,11.337884187082409,15.918662747979431,10.177772608857463,1361,5374,2100,4635,6735
Southport Ave & Clybourn Ave,14.756903807119153,18.11998842090027,13.008555304740394,2303,4430,2657,4076,6733
Ada St & Washington Blvd,12.74560775540642,17.172945978808411,10.970417189023545,1919,4786,2370,4335,6705
Racine Ave & Wrightwood Ave,11.850017634018529,13.479455880006386,11.09810765039393,2089,4527,1978,4638,6616
Ashland Ave & Blackhawk St,15.553848886182577,18.883256208545426,13.921623563218391,2161,4408,2651,3918,6569
Michigan Ave & Ida B Wells Dr,23.520709923664135,33.634814607788336,11.344307985643786,3578,2972,1521,5029,6550
Lake Park Ave & 53rd St,20.208180463491086,30.05673137626265,15.453862857142861,2112,4375,1286,5201,6487
Wells St & Institute Pl,10.807407693098837,14.984889533946138,8.8516081540203864,2067,4415,1589,4893,6482
Walsh Park,18.516963732176084,26.897986974541155,14.023138888888896,2252,4200,2294,4158,6452
Fairbanks St & Superior St,18.529309542280863,30.043164238172341,13.883148228803725,1853,4592,2055,4390,6445
Clark St & Bryn Mawr Ave,16.052398361335811,20.702431791221837,14.002047373533589,1967,4461,2837,3591,6428
Clark St & Montrose Ave,13.862339618721107,18.045825958702064,11.587940020848357,2260,4157,2299,4118,6417
Broadway & Berwyn Ave,16.320722979679264,22.132002129925446,13.897098230809091,1878,4503,2010,4371,6381
Clinton St & Roosevelt Rd,14.437853196527245,17.463065169940748,12.896775474545315,2138,4197,2358,3977,6335
Delano Ct & Roosevelt Rd,17.975914763113362,23.576955912334377,14.002941973969628,2616,3688,1986,4318,6304
Ashland Ave & Grace St,13.424614605003475,16.469932165956774,11.868822533849135,2113,4136,2336,3913,6249
Western Ave & Leland Ave,13.908197383298337,18.0910153256705,12.273036021867748,1740,4451,2816,3375,6191
Sheridan Rd & Argyle St,18.9539316100363,28.204843724431349,14.373448387619513,2037,4114,2250,3901,6151
Ashland Ave & Augusta Blvd,14.34470977624596,17.182168525402723,13.54092249368154,1345,4748,2267,3826,6093
Larrabee St & North Ave,13.501230777740899,18.847811544342509,11.323641600498206,1744,4282,1947,4079,6026
Ashland Ave & Wellington Ave,12.824755310866426,17.277343223196226,11.360958397990087,1483,4511,2299,3695,5994
Paulina Ave & North Ave,14.690386441056564,18.451388196176236,12.788063403969058,2005,3964,2323,3646,5969
Streeter Dr/Grand Ave,29.046690307328557,32.924803946369884,21.26091924834941,3953,1969,1446,4476,5922
Clinton St & Tilden St,12.285817787666165,20.590988056460375,9.3265707211389621,1535,4308,1833,4010,5843
Canal St & Taylor St,12.629598834219102,16.893578824315291,10.411484666840414,1996,3837,1896,3937,5833
Marine Dr & Ainslie St,26.292235953770426,38.524656285072972,17.867821256038649,2376,3450,1844,3982,5826
Broadway & Granville Ave,25.119321888411996,36.291426743442088,18.895674062193727,2084,3741,1866,3959,5825
Ashland Ave & Chicago Ave,13.037762801681927,18.073312820512815,11.071696299855846,1625,4162,2182,3605,5787
Sheridan Rd & Lawrence Ave,15.537589326878743,23.987874531835207,11.780969030969038,1780,4004,1707,4077,5784
Hermitage Ave & Polk St,13.40924260764311,19.500108932461877,12.259928057553955,918,4865,2190,3593,5783
Damen Ave & Leland Ave,13.331998150395934,17.518720015352148,11.52744830438378,1737,4030,2155,3612,5767
Clybourn Ave & Division St,11.217683922117288,15.262414837244512,10.002516867561216,1321,4397,1457,4261,5718
Loomis St & Jackson Blvd,12.919640666082385,18.025258580159846,11.230868517222612,1418,4287,1604,4101,5705
Elizabeth St & Fulton St,12.308175438596495,15.123719206453016,11.276056900823153,1529,4171,2824,2876,5700
Wood St & Augusta Blvd,13.797262848751835,17.512032736120336,12.454134676903395,1507,4168,2306,3369,5675
Broadway & Thorndale Ave,21.688040532579272,31.392245030954733,16.191140642303424,2046,3612,1771,3887,5658
Winthrop Ave & Lawrence Ave,14.929045508274225,19.714564322776891,12.568595004853934,1863,3777,2016,3624,5640
Ellis Ave & 53rd St,10.32720924704344,16.569688109161792,7.9667239967239984,1539,4070,840,4769,5609
Greenview Ave & Diversey Pkwy,13.513038934670972,15.925461717769412,12.308447488584472,1859,3723,1636,3946,5582
Wood St & Taylor St (Temp),12.599404227291778,16.546790299572042,12.030740512398946,701,4866,2017,3550,5567
Western Ave & Walton St,15.737828729614247,19.477720813095875,13.857736480376181,1853,3686,2222,3317,5539
Racine Ave & 18th St,14.557836905194332,18.227623724244168,12.8750816777042,1731,3775,2256,3250,5506
Cannon Dr & Fullerton Ave,31.393028203257938,40.538489063602476,17.500497626703414,3307,2177,1047,4437,5484
Sheridan Rd & Noyes St (NU),15.430584160843459,19.592541757443716,12.391547353908154,2295,3143,1268,4170,5438
State St & 35th St,11.306297532925246,18.980262423227245,10.350653594771243,597,4794,1787,3604,5391
Clarendon Ave & Leland Ave,18.868728330856865,27.632045337454908,13.928386097395672,1941,3443,1838,3546,5384
Leavitt St & Armitage Ave,13.70050223214286,19.35405150753769,11.321947674418604,1592,3784,2180,3196,5376
Orleans St & Elm St,12.271923436041085,16.21290460878885,10.659232456140359,1555,3800,1769,3586,5355
Clark St & 9th St (AMLI),14.211395261376456,19.534093982420565,11.074407252440727,1972,3346,1882,3436,5318
Dearborn St & Van Buren St,17.654100177304947,25.091991143686066,12.384085253705512,2183,3081,1252,4012,5264
University Ave & 59th St,9.9572306510466717,18.693473282442746,7.0204901206055981,1310,3897,681,4526,5207
Ravenswood Ave & Irving Park Rd,12.823278183916893,15.793754565376179,11.761230086184375,1369,3829,2112,3086,5198
Ashland Ave & Lake St,13.063625561978165,16.293117831074039,11.170542991035038,1918,3272,1755,3435,5190
Emerald Ave & 31st St,13.167414675215339,18.649455337690622,11.977413888232059,918,4229,1554,3593,5147
Campbell Ave & North Ave,14.839725894245728,17.4595472061657,13.512165592657682,1730,3414,1897,3247,5144
Lincoln Ave & Sunnyside Ave,14.525212427839396,19.029470672389127,12.431014823261117,1631,3508,1988,3151,5139
Western Ave & Division St,15.241717350075193,16.689700272479563,14.427171469446154,1835,3262,1699,3398,5097
Ashland Ave & Wrightwood Ave,13.537868906455865,17.444523326572003,11.924369356790468,1479,3581,1626,3434,5060
Blackstone Ave & Hyde Park Blvd,18.665720783072985,28.269730618959485,14.134841870391934,1621,3436,920,4137,5057
Leavitt St & North Ave,13.137136131556264,16.493304172274563,11.728701873293799,1486,3541,1775,3252,5027
Paulina St & Montrose Ave,12.611075739487994,18.5448,10.64678672316384,1250,3776,1596,3430,5026
Racine Ave & Washington Blvd,11.753933293468871,15.538246913580249,10.360744477774752,1350,3667,1687,3330,5017
Larrabee St & Menomonee St,14.444669203551637,21.436569037656906,12.24474284711251,1195,3798,1166,3827,4993
Wolcott (Ravenswood) Ave & Montrose Ave,12.619410733549078,16.155831698277737,11.036046852122983,1529,3415,2002,2942,4944
Seeley Ave & Roscoe St,16.035208333333333,18.621207398171229,14.769047619047603,1604,3276,2222,2658,4880
Fort Dearborn Dr & 31st St*,29.966246067569426,41.232178895159905,22.4594757834758,1949,2925,846,4028,4874
LaSalle St & Adams St,17.845522949586151,28.62419132149903,12.12263587810242,1690,3183,1715,3158,4873
Noble St & Milwaukee Ave,13.888299993125729,16.959644194756553,12.611338199513389,1424,3425,1857,2992,4849
Benson Ave & Church St,23.21344041450779,32.151501937984484,16.531745744295542,2064,2761,1522,3303,4825
Damen Ave & Charleston St,15.089089275843007,16.687411723163841,14.061285195277025,1888,2936,2119,2705,4824
Broadway & Ridge Ave,20.671679538022676,29.215041782729823,17.014967709885731,1436,3355,1684,3107,4791
Damen Ave & Grand Ave,13.95540767134773,16.273136746597533,12.847521685254025,1543,3228,1937,2834,4771
Albany Ave & Bloomingdale Ave,17.312625726023509,22.994656336909014,14.163865037428438,1678,3028,1828,2878,4706
Chicago Ave & Sheridan Rd,20.915067157712308,30.06954447522315,12.821761904761916,2166,2450,870,3746,4616
Artesian Ave & Hubbard St,12.783550535766,16.788755364806871,11.426742270039737,1165,3439,2228,2376,4604
Wentworth Ave & Cermak Rd*,20.259774381368274,26.310163909313747,14.783215474209646,2176,2404,1567,3013,4580
Blue Island Ave & 18th St,14.452842151289895,19.662544125063029,12.334998974989736,1322,3252,1692,2882,4574
Shields Ave & 31st St,9.992969723627299,19.713256113256115,8.7432530818234468,518,4029,1740,2807,4547
Ashland Ave & Grand Ave,13.325592225889249,16.655792466240218,11.832414489058854,1407,3138,1721,2824,4545
Spaulding Ave & Armitage Ave,17.264798913841194,20.885233270002111,15.335448306896161,1579,2963,2031,2511,4542
California Ave & Cortez St,15.188885170310879,16.504661864745902,14.410446259469706,1666,2816,2093,2389,4482
Morgan St & 18th St,15.169304904368532,20.532026143790844,11.941314973772053,1683,2796,1794,2685,4479
Leavitt St & Chicago Ave,14.305485940180498,18.569118324125235,12.261877965353641,1448,3021,1894,2575,4469
Sedgwick St & Schiller St,14.881526964097946,20.107203114860475,12.101835231849039,1541,2897,1198,3240,4438
N Green St & W Lake St,10.581504157218451,10.820125363778825,10.459865342919091,1489,2921,4410,0,4410
Logan Blvd & Elston Ave,15.376940326871905,16.76299102132436,14.861886143259314,1188,3197,1914,2471,4385
Indiana Ave & 31st St,13.274195389180543,31.03062922516899,10.230913547237071,641,3740,915,3466,4381
Calumet Ave & 21st St,26.314005765934233,36.153737505432439,14.861692800539538,2301,1977,1526,2752,4278
Clark St & Randolph St,16.839601406799538,27.971958584987057,12.685576303927871,1159,3106,1147,3118,4265
Western Ave & Fillmore St,13.297854397113047,20.114739229024945,12.202981881088959,588,3661,2113,2136,4249
Lincoln Ave & Belle Plaine Ave,14.592015850596363,17.830338239091141,13.178192988389133,1291,2957,1556,2692,4248
Humboldt Blvd & Armitage Ave,17.064219279577522,22.198718724778058,13.772720217306937,1652,2577,1444,2785,4229
Leavitt St & Division St,12.581502091719944,16.612786800721839,10.802508532423202,1293,2930,1466,2757,4223
Drexel Ave & 60th St,11.842867993923409,18.381872447376683,9.6106016731016766,1061,3108,679,3490,4169
Stave St & Armitage Ave,14.886604624929497,18.142211838006226,13.237460548676864,1391,2746,1837,2300,4137
California Ave & Francis Pl,15.656335884143841,18.713169692893967,13.883515340613616,1487,2564,1627,2424,4051
Wentworth Ave & Cermak Rd,24.7710687857383,32.654669703872443,14.988986244582618,2195,1769,1279,2685,3964
Leavitt St & Belmont Ave,17.676091169531507,20.999099099099098,15.352269473081328,1628,2328,1770,2186,3956
Damen Ave & Wellington Ave,14.580344478216807,17.433756278086168,13.241247984121072,1261,2687,1689,2259,3948
Kedzie Ave & Palmer Ct,15.444334192439841,19.165419901199719,13.303539044525644,1417,2463,1296,2584,3880
Wood St & Hubbard St,14.024161939143882,17.30906432748538,12.656452398344289,1140,2738,1406,2472,3878
Lincoln Ave & Waveland Ave,14.255263385146796,16.866042966042972,13.388607085346221,962,2898,1307,2553,3860
Lincoln Ave & Byron St,14.796924937375831,16.807272727272721,13.816551015163197,1265,2594,1548,2311,3859
Wilton Ave & Diversey Pkwy*,12.621664934164937,15.499848714069593,11.11534705727105,1322,2526,955,2893,3848
Morgan Ave & 14th Pl,12.140013071895423,17.165483870967744,10.525613126079451,930,2895,1521,2304,3825
Damen Ave & Clybourn Ave,16.41696319553462,18.955738396624461,15.276102894703595,1185,2637,1493,2329,3822
Fort Dearborn Dr & 31st St,32.570449389179743,43.88303712480252,23.613766416510316,1688,2132,818,3002,3820
Racine Ave & Randolph St,12.722718539865502,17.247313854853907,10.980847847121433,1061,2756,1140,2677,3817
Sheridan Rd & Loyola Ave,22.875004390586575,34.373114355231124,14.091132280049569,1644,2152,1332,2464,3796
Halsted St & 18th St,15.962942222222219,21.634024517475215,13.031047734627832,1278,2472,1462,2288,3750
Paulina St & 18th St,15.544439996441573,19.760664433277491,13.572574748661706,1194,2553,1438,2309,3747
Ravenswood Ave & Berteau Ave,13.018625346570078,19.022363569321538,11.096068012752392,904,2823,1176,2551,3727
Damen Ave & Foster Ave,14.068390650188073,14.884064427690195,13.542509942554135,1459,2263,1687,2035,3722
Lake Park Ave & 35th St,26.036872394417266,42.6752617801047,18.506226961558717,1146,2532,850,2828,3678
Clark St & Lunt Ave,13.805060506050602,20.459642857142864,10.276115319865315,1260,2376,1508,2128,3636
California Ave & North Ave,15.360487479767688,20.19168152109329,13.081967213114757,1122,2379,1319,2182,3501
Ogden Ave & Congress Pkwy,15.478274577242756,19.01001727115716,14.474776101091891,772,2717,1423,2066,3489
Glenwood Ave & Morse Ave,18.682006369426748,27.544192682108083,15.106162806447257,993,2461,1171,2283,3454
Indiana Ave & 26th St,16.450198990487284,24.9055619047619,13.559053015500847,875,2559,1114,2320,3434
Morgan St & 31st St,15.654349308396661,22.91541950113379,13.668161518422023,735,2687,1456,1966,3422
Wabash Ave & Cermak Rd,20.298322446555812,27.728756957328383,13.436521987435748,1617,1751,1106,2262,3368
Damen Ave & Melrose Ave,14.55274069579287,17.449953959484347,13.129042232277531,1086,2210,1207,2089,3296
Milwaukee Ave & Rockwell St,16.164029729179397,18.258883768561191,14.78091615956728,1302,1972,1263,2011,3274
Damen Ave & Sunnyside Ave,15.786876923076923,17.953248004404074,14.500228870361285,1211,2039,1013,2237,3250
Lincoln Ave & Addison St,17.55012960082945,22.265999406880194,15.015152239757692,1124,2091,1044,2171,3215
Southport Ave & Clark St,13.764035361414454,17.329056270502136,11.264357749469218,1321,1884,1040,2165,3205
California Ave & Division St,17.770058855002688,21.953621364653252,15.176815739296249,1192,1923,1249,1866,3115
California Ave & Montrose Ave,22.709127502175793,29.282686383240904,19.120534813319857,1082,1982,918,2146,3064
Western Ave & Congress Pkwy,15.176776940714053,25.431517094017092,12.542376835460404,624,2429,1333,1720,3053
California Ave & Altgeld St,16.352876202974624,20.549321503131523,14.429338118022327,958,2090,1068,1980,3048
Calumet Ave & 35th St,13.20830871895854,29.373900074571214,10.429070512820513,447,2600,925,2122,3047
Wentworth Ave & 33rd St,14.009984664256766,30.015521628498728,10.680527987296541,524,2519,979,2064,3043
Leavitt St & Lawrence Ave,15.230337941628266,16.485523114355235,14.521953312736013,1096,1942,1105,1933,3038
Ashland Ave & 13th St,13.654671088999454,21.562632978723407,12.527958822786408,376,2639,1077,1938,3015
Canal St & Harrison St,13.28354465576688,20.887230094466933,9.5441513190642073,988,2009,754,2243,2997
Clark St & Elmdale Ave,18.28997175141242,22.340866117718814,15.905681206246639,1093,1857,1055,1895,2950
Elston Ave & Wabansia Ave,15.563336737009301,17.0218868474774,14.634577530176422,1143,1795,1198,1740,2938
Clinton St & 18th St,17.303022904313462,17.239763421292086,17.342345399698349,1099,1768,1094,1773,2867
St. Louis Ave & Fullerton Ave,17.875156121126444,22.678453534266229,15.526596491228075,929,1900,977,1852,2829
Talman Ave & Addison St,18.335384978186546,19.663092818428193,17.626505697232794,984,1843,1264,1563,2827
Halsted St & 35th St,15.865576991782779,21.630660954712358,13.489152371342071,817,1982,944,1855,2799
Campbell Ave & Montrose Ave,14.146209407831893,17.036024196912809,12.987673524000666,799,1993,1065,1727,2792
Damen Ave & Madison St,16.945084320057415,22.259160756501192,13.331896724934692,1128,1659,1131,1656,2787
Harper Ave & 59th St,12.820642642642648,24.164388311045077,9.18870123691722,673,2102,348,2427,2775
Winchester Ave & Elston Ave,14.816776075857025,16.455299417064122,14.329018772677074,629,2113,1111,1631,2742
Rockwell St & Eastwood Ave,15.225219298245623,17.18030503978779,14.481458123107965,754,1982,1043,1693,2736
Greenview Ave & Jarvis Ave,15.011971142088518,17.660457181849203,13.532513817419481,977,1749,927,1799,2726
Damen Ave & Wabansia Ave,12.285520029400958,13.622970085470088,11.584201680672273,936,1785,2721,0,2721
Claremont Ave & Hirsch St,12.60651080019637,14.022785547785551,11.952493720846794,858,1858,1088,1628,2716
Museum of Science and Industry,36.165242323344437,44.781219211822638,23.197358665430954,1624,1079,454,2249,2703
State St & 19th St,17.926992481202991,23.950870147255689,14.321354166666673,996,1664,683,1977,2660
Western Ave & Roscoe St,15.025834277798767,18.916168091168093,13.621713796058263,702,1945,900,1747,2647
Wood St & Webster Ave,13.545466565923681,14.13722943722944,13.267009259259252,847,1800,898,1749,2647
Ashland Ave & Belle Plaine Ave,16.718028907649018,20.380267828331718,14.313011231193048,1033,1573,984,1622,2606
Emerald Ave & 28th St,16.389914135588882,23.553299776286352,14.260548628428921,596,2005,565,2036,2601
Clark St & Schreiber Ave,16.733249710536473,18.7781668580176,15.697713178294574,871,1720,943,1648,2591
Halsted St & Archer Ave,11.847536343754024,15.92283671933785,9.7298142717497562,886,1705,1076,1515,2591
Racine Ave & 15th St,16.176625466718161,22.224685739055051,13.621153846153849,769,1820,1039,1550,2589
Sheridan Rd & Columbia Ave,20.603679147165881,27.721086873325685,16.941976767080124,871,1693,839,1725,2564
Griffin Museum of Science and Industry,42.3839678178963,50.210197910940074,22.855967078189295,1819,729,534,2014,2548
Milwaukee Ave & Fullerton Ave,10.879202955925049,10.4618265993266,11.249788241155954,1188,1338,2526,0,2526
W Armitage Ave & N Sheffield Ave,9.543844320889594,10.316750948166876,9.1898378691372375,791,1727,2518,0,2518
Shields Ave & 28th Pl,13.324657258064516,20.744495884773663,12.209616573902297,324,2156,981,1499,2480
Kimball Ave & Belmont Ave,14.641292517006805,17.098074807480739,13.192093878433912,909,1541,1097,1353,2450
Richmond St & Diversey Ave,19.09324381032312,23.716305133767161,16.175747205110653,922,1461,901,1482,2383
Halsted St & 21st St,14.956745362563234,16.2949975949976,14.404387532261264,693,1679,897,1475,2372
Campbell Ave & Fullerton Ave,17.689850788288275,23.202170713760118,14.27387140902874,906,1462,1000,1368,2368
May St & Cullerton St,14.555668215744264,19.177872230808862,12.816967054263563,647,1720,965,1402,2367
Greenwood Ave & 47th St,18.491317961855955,26.768627450980389,15.56315992292871,612,1730,773,1569,2342
Laflin St & Cullerton St,16.404391602399304,19.146222498962224,14.966318310472458,803,1531,877,1457,2334
Wentworth Ave & 35th St,13.464762931034478,16.040808956301916,11.762765449773323,923,1397,717,1603,2320
Avondale Ave & Irving Park Rd,16.383409194355941,20.142000000000003,14.4352798894264,750,1447,999,1198,2197
Oakley Ave & Irving Park Rd,16.164297646165526,18.703783939919123,15.258683559950551,577,1618,597,1598,2195
California Ave & Byron St,18.634365917087358,21.103949652777775,17.290184266477677,768,1411,949,1230,2179
Leavitt St & Addison St,17.802143299288151,21.781431897555304,15.162599742599737,859,1295,797,1357,2154
Damen Ave & Walnut (Lake) St,16.21465891472868,20.183167613636364,14.282549562010141,704,1446,1069,1081,2150
University Library (NU),21.102223782771542,29.427436219155165,16.146888225043565,797,1339,628,1508,2136
Clark St & Columbia Ave,13.496309355900328,16.073675496688743,12.474162836506899,604,1523,699,1428,2127
California Ave & Fletcher St,17.769730158730152,21.797901821060957,15.073608903020668,842,1258,844,1256,2100
Kedzie Ave & Leland Ave,18.03967643761013,22.509262435677535,16.300178015131284,583,1498,916,1165,2081
Hampden Ct & Diversey Ave,10.365160256410253,10.6949297188755,10.210522598870057,664,1416,2080,0,2080
Washtenaw Ave & Lawrence Ave,16.064842615012093,21.467130987292272,13.400807423475534,682,1383,816,1249,2065
Central Park Ave & Elbridge Ave,18.163705501618121,20.189953379953376,17.086555142503094,715,1345,993,1067,2060
Hoyne Ave & Balmoral Ave,14.866049983771498,22.980989994734067,11.251161154116824,633,1421,1234,820,2054
Campbell Ave & Augusta Blvd,11.070814778162624,10.507485380116956,11.483890794739855,855,1166,2021,0,2021
Damen Ave & Cullerton St,16.702944582299416,22.058905852417297,14.123419117647064,655,1360,811,1204,2015
Chicago Ave & Washington St,23.752642073778681,31.654447960618839,16.672385003150605,948,1058,766,1240,2006
Wells St & 19th St,23.865205410821638,27.475450819672115,18.189304123711338,1220,776,470,1526,1996
Wallace St & 35th St,12.914509115236656,18.869871794871788,10.812140755827111,520,1473,528,1465,1993
Troy St & Elston Ave,16.1998324958124,18.897469135802467,15.195195402298841,540,1450,811,1179,1990
Sheridan Rd & Greenleaf Ave,23.41271617497458,37.6411402157165,16.401138952164011,649,1317,478,1488,1966
Kosciuszko Park,19.71041238877482,23.589255499153975,17.075474137931035,788,1160,965,983,1948
Paulina St & Howard St,15.235432033719709,19.83086989992302,11.379182816537469,866,1032,668,1230,1898
Cherry Ave & Blackhawk St,12.633579335793359,12.859069767441861,12.517412140575082,645,1252,762,1135,1897
Glenwood Ave & Touhy Ave,14.948139287612966,14.707782839787395,15.158541043536056,878,1003,722,1159,1881
Halsted St & North Branch St,14.309406028368803,18.199677419354842,12.395145502645505,620,1260,523,1357,1880
Malcolm X College,20.206139882541368,29.503472222222207,15.561195623165199,624,1249,692,1181,1873
Troy St & North Ave,18.868656316916493,20.4860569105691,17.603132951653947,820,1048,683,1185,1868
Francisco Ave & Foster Ave,18.280615164520743,25.215661478599223,15.640160493827164,514,1350,790,1074,1864
Lincoln Ave & Winona St,16.1822453830682,19.684032091097315,14.269479785128636,644,1179,810,1013,1823
Avers Ave & Belmont Ave,19.853805342114882,21.807492912110167,18.244310977644318,823,999,983,839,1822
Smith Park,17.591263736263752,22.277619047619044,15.508439153439159,560,1260,700,1120,1820
N Carpenter St & W Lake St,10.498331499816649,10.395179904955873,10.536498367244411,491,1327,1818,0,1818
Ogden Ave & Roosevelt Rd,15.717043366409417,18.928156996587028,15.098465921542841,293,1521,870,944,1814
Albany Ave & Montrose Ave,18.635538261997414,20.096358024691366,18.008975377283555,540,1259,681,1118,1799
Central Park Ave & Bloomingdale Ave,26.24612403100776,32.5171462829736,20.616379619662723,834,929,588,1175,1763
Monticello Ave & Irving Park Rd,15.857363240583002,20.123583517292129,14.379841997961258,453,1308,1090,671,1761
Wentworth Ave & 24th St,22.441014658290502,32.86416781292985,15.040983072916669,727,1024,560,1191,1751
W Oakdale Ave & N Broadway,11.397356321839078,10.953170594837264,11.627588714368819,594,1146,1740,0,1740
Western Ave & Monroe St,15.922820362785249,23.553543613707163,13.373289097059587,428,1281,705,1004,1709
Lake Park Ave & 47th St,28.82377657440831,40.3052179656539,19.219963167587469,757,905,396,1266,1662
W Washington Blvd & N Peoria St,10.152068052159738,11.970770338372924,9.4342000568343281,463,1173,1636,0,1636
Racine Ave & 35th St,15.766720639032815,18.513730803974703,14.904042553191486,369,1175,625,919,1544
Woodlawn Ave & Lake Park Ave,22.644716242661442,35.22533950617283,15.80328969452837,540,993,322,1211,1533
Spaulding Ave & Division St,16.399520697167759,18.635446009389675,15.079348579348569,568,962,917,613,1530
Winchester (Ravenswood) Ave & Balmoral Ave,16.680216711349413,17.763339070567984,15.989443834613978,581,911,708,784,1492
Manor Ave & Leland Ave,18.101534642292929,20.848000000000003,16.898117494320026,450,1027,689,788,1477
Western Ave & Lunt Ave,15.936925875397908,18.024028122415221,15.145672624647231,403,1063,650,816,1466
Rockwell St & Fletcher St,13.440157750342934,13.493520090548959,13.403989259685462,589,869,1458,0,1458
Normal Ave & Archer Ave,15.254889042995847,21.468282828282835,13.410986211031171,330,1112,608,834,1442
Leavitt St/North Ave,13.368488857938722,17.495569105691054,11.719265756985047,410,1026,553,883,1436
Christiana Ave & Lawrence Ave,18.551896921975665,23.352290950744564,15.123885480572595,582,815,673,724,1397
Noble St & Milwaukee Ave (Temp),13.694815613026822,14.663128930817612,13.270678374655652,424,968,583,809,1392
Drake Ave & Addison St,13.536505612493904,15.500952380952381,12.310186286167262,525,841,769,597,1366
Eastlake Ter & Howard St,21.157313054499365,35.255285412262161,13.23766825019794,473,842,413,902,1315
MLK Jr Dr & Pershing Rd,22.473315329218106,38.722650602409651,14.818974650018919,415,881,487,809,1296
Elston Ave & George St,13.683021172638439,12.584057971014493,14.24195331695331,414,814,1228,0,1228
N Southport Ave & W Newport Ave,10.126400329489289,10.466097190584662,9.9339784946236556,439,775,1214,0,1214
63rd St Beach,36.255477178423227,43.971272229822141,24.356223628691989,731,474,224,981,1205
Dorchester Ave & 49th St,21.71468715393134,26.688414055080724,19.668053927315349,351,853,244,960,1204
Evanston Civic Center,23.483083956774738,29.318086696562037,16.172940074906368,669,534,344,859,1203
N Paulina St & Lincoln Ave,9.6721434528774,9.575126646403243,9.7088314176245181,329,870,1199,0,1199
Loomis St & Archer Ave,14.357544006705778,16.486560457516337,13.250997876857751,408,785,358,835,1193
Clark St & Jarvis Ave,13.739239618406282,18.2156378600823,12.060590277777777,324,864,341,847,1188
Racine Ave & 13th St,13.483133561643831,17.905477528089886,11.544273399014777,356,812,385,783,1168
South Shore Dr & 67th St,39.1095463680735,50.713056163384387,31.577154356060614,457,704,240,921,1161
Sawyer Ave & Irving Park Rd,17.518499278499288,23.035031595576616,14.342542064574809,422,733,580,575,1155
Western Ave & 21st St,17.905927536231882,25.658126036484251,13.739639037433154,402,748,488,662,1150
South Shore Dr & 71st St,32.517424242424276,40.661420982735727,26.149376947040494,502,642,312,832,1144
Prairie Ave & Garfield Blvd,13.995550660792954,20.022523499638471,9.8732443125618214,461,674,252,883,1135
Ashland Ave & Archer Ave,13.649617196702003,16.231200631911531,12.115211267605636,422,710,359,773,1132
Cottage Grove Ave & 63rd St,16.814994026284335,20.891545893719805,14.990856031128406,345,771,408,708,1116
Bernard St & Elston Ave,16.843931159420293,19.502834467120184,15.878847736625508,294,810,547,557,1104
Cottage Grove Ave & 47th St,19.17594610959733,29.094947209653089,16.684924242424241,221,880,274,827,1101
Cottage Grove Ave & 51st St,19.184416589291242,26.37351598173516,15.498993445692888,365,712,327,750,1077
Western Ave & Howard St,15.502028714107361,19.721114683815649,13.768692206076615,311,757,333,735,1068
Central St Metra,25.25299267749125,27.04779326364692,23.074947145877392,574,473,348,699,1047
Drake Ave & Montrose Ave,19.547587088526686,23.5990488006617,16.996432291666668,403,640,417,626,1043
Clinton St & Polk St,16.733086297760213,20.50297280202404,12.636735395189001,527,485,288,724,1012
Francisco Ave & Chicago Ave,12.150922266139657,13.18064903846154,11.432186800894856,416,596,1012,0,1012
Dorchester Ave & 63rd St,20.620825016633397,35.059152542372885,14.59634606317775,295,707,186,816,1002
Warren Park West,19.749728997289957,27.596863468634691,16.767157550257135,271,713,335,649,984
N Damen Ave & W Chicago Ave,9.77970128988459,10.510092961487384,9.528910168718653,251,731,982,0,982
Knox Ave & Montrose Ave,17.305497014401126,16.842822736030829,17.570978441127696,346,603,459,490,949
Clark St & Touhy Ave,15.371491693177797,22.714930555555554,11.306589785831962,336,607,471,472,943
St. Louis Ave & Balmoral Ave,21.397517342095643,25.060536980749745,19.333932648401834,329,584,478,435,913
State St & 29th St,20.406341374269015,27.631224489795922,17.75252373813094,245,667,280,632,912
Cottage Grove Ave & Oakwood Blvd,37.581481481481468,49.756017643352244,20.633245614035097,529,380,239,670,909
Kedzie Ave & Foster Ave,19.838729281767961,24.302855805243439,16.94395871281117,356,549,301,604,905
California Ave & Lake St,20.301057906458809,19.332355338223312,21.111281526925691,409,489,281,617,898
Keystone Ave & Fullerton Ave,19.315586592178775,23.417122593718343,16.931478209658415,329,566,343,552,895
Western Ave & Grace St,11.20481651376147,10.841389599317987,11.500242550242554,391,481,872,0,872
Central St & Girard Ave,25.416880591209654,29.641030789825965,19.557195914577527,498,359,195,662,857
Western Ave & Berteau Ave,11.673092131277178,10.628007518796993,12.154881571346037,266,577,843,0,843
McCormick Blvd & Devon Ave,26.927184657967569,31.861794871794864,22.678844738778512,390,453,260,583,843
Dodge Ave & Church St,17.396285260230432,19.164583333333329,15.785079726651476,400,439,310,529,839
Francisco Ave & Bloomingdale Ave,10.706654530744338,9.6652070604209079,12.242242242242245,491,333,824,0,824
Keystone Ave & Montrose Ave,17.999755201958369,21.938746958637473,16.012124002455504,274,543,376,441,817
Western Ave & Gunnison St,11.341068481848186,11.930414746543779,11.124675690919341,217,591,808,0,808
Leavitt St & Archer Ave,20.702994630318052,24.779893529893531,16.55475,407,400,268,539,807
Kildare Ave & Montrose Ave,19.177060041407874,23.99659498207885,16.620690747782007,279,526,235,570,805
Cottage Grove Ave & 43rd St,22.039270833333333,39.757942708333331,13.701072303921569,256,544,330,470,800
N Sheffield Ave & W Wellington Ave,9.2442355889724368,9.5269379844961239,9.1091666666666633,258,540,798,0,798
Bosworth Ave & Howard St,18.393605870020963,32.461735700197231,14.595660276890309,169,626,256,539,795
Milwaukee Ave & Cuyler Ave,15.811825902335459,18.49014336917563,14.335046113306984,279,506,413,372,785
Ping Tom Park (East),12.145769230769231,13.521055226824457,11.094079939668175,338,442,780,0,780
Western Ave & Granville Ave,18.224294871794875,22.081267217630849,16.489374225526646,242,538,414,366,780
Kedzie Ave & George St,11.609373659373658,11.109122287968441,11.994533029612759,338,439,777,0,777
Ridge Blvd & Touhy Ave,14.676975945017183,18.924608904933816,12.319071476285902,277,499,283,493,776
Francisco Ave & Montrose Ave,11.047919375812743,11.108777429467084,11.004777777777779,319,450,769,0,769
Valli Produce - Evanston Plaza,20.50311546840959,23.658849557522124,17.991862284820044,339,426,249,516,765
Buckingham Fountain (Temp),23.0054211469534,29.129953917050695,14.431075268817207,434,310,138,606,744
Central Park Ave & North Ave,21.88349035441902,27.713167587476981,16.344531933508307,362,381,283,460,743
Monticello Ave & Lawrence Ave,15.448301630434772,16.487476979742169,14.442468805704095,362,374,357,379,736
N Shore Channel Trail & Argyle St,13.256978879706155,16.391758241758239,11.367807211184694,273,453,726,0,726
Wood St & 35th St,15.848510638297876,26.84868173258004,12.160953282828281,177,528,282,423,705
Ridge Blvd & Howard St,17.053223495702007,28.859545454545454,11.619351464435145,220,478,269,429,698
Kedzie Ave & Bryn Mawr Ave,18.659421329507403,25.745670995671002,15.146709585121602,231,466,213,484,697
Lincoln Ave & Peterson Ave,22.158006773101114,33.696652110625919,16.413768115942023,229,460,251,438,689
Warren Park East,22.007302280446382,33.337275985663076,14.259599673202615,279,408,205,482,687
Calumet Ave & 51st St,14.605389221556885,20.481824712643675,11.47847859327217,232,436,305,363,668
DuSable Museum,16.550531107738994,22.973732718894009,13.397058823529413,217,442,127,532,659
Troy St & Grace St,10.936891961085506,9.2274509803921561,11.717039522744217,204,447,651,0,651
Oakley Ave & Touhy Ave,17.0879355174207,17.0361673414305,17.120389170896786,247,394,299,342,641
Elmwood Ave & Austin St,22.615572916666672,29.133055555555554,16.864852941176469,300,340,249,391,640
Sacramento Blvd & Addison St,10.021076115485561,9.9866795366795351,10.044769503546096,259,376,635,0,635
Kilbourn Ave & Irving Park Rd,17.607723577235767,17.796540880503144,17.508395368072783,212,403,236,379,615
Damen Ave/Coulter St,22.077351821642196,26.644260027662519,19.118682795698923,241,372,306,307,613
Kedzie Ave & Lake St,17.59908180300501,18.087640449438204,17.206174698795181,267,332,359,240,599
Western Ave & 24th St,17.17826330532213,19.225505050505053,16.157220822837942,198,397,308,287,595
Budlong Woods Library,20.151980758347488,26.531705729166664,15.247447447447446,256,333,246,343,589
California Ave & 21st St,22.775643224699838,25.204921259842514,20.900151975683894,254,329,223,360,583
MLK Jr Dr & 47th St,19.946903935185187,27.522655122655124,14.874444444444444,231,345,138,438,576
California Ave & Granville Ave,15.581823461091753,22.265753424657532,13.301791277258571,146,428,194,380,574
Central Park Ave & Ogden Ave,15.826386456509049,15.852716823406478,15.793055555555551,319,252,295,276,571
Prairie Ave & 43rd St,20.993660714285724,26.540706126687436,13.543444909344492,321,239,233,327,560
California Ave & Winona St,12.644464500601687,10.091904761904761,13.507648953301132,140,414,554,0,554
Elston Ave & Henderson St,11.833087783916511,10.023344748858445,13.938446215139441,292,251,543,0,543
Kedzie Ave & 48th Pl,13.280049109883363,15.501494565217392,8.6086666666666662,368,175,331,212,543
Maplewood Ave & Peterson Ave,18.453021806853585,29.064480874316938,15.318401937046003,122,413,168,367,535
Kedzie Ave & Chicago Ave,18.335583016476548,19.667738791423005,17.693896713615025,171,355,253,273,526
2112 W Peterson Ave,16.1336858974359,19.345900178253125,14.32982982982983,187,333,281,239,520
Albany Ave & Belmont Ave,12.537483912483912,12.031238095238097,12.795772594752187,175,343,518,0,518
Pulaski Rd & 51st St,14.876305609284332,18.623004694835682,10.309513590844064,284,233,366,151,517
Pulaski Rd & Eddy St,21.549187784275514,26.120934256055364,15.650818452380953,289,224,184,329,513
Dodge Ave & Mulford St,20.131955645161295,23.076930320150655,18.497910135841174,177,319,146,350,496
California Ave & 23rd Pl,19.2372311827957,18.854215686274507,19.436963190184048,170,326,131,365,496
Halsted St & 37th St,19.480577956989247,33.356385281385279,13.232407407407408,154,342,190,306,496
Public Rack - Washtenaw Ave & Superior St,12.494006734006733,12.919642857142858,12.326150234741785,140,355,495,0,495
Archer (Damen) Ave & 37th St,24.168969072164952,24.493129770992365,24.049011299435033,131,354,129,356,485
MTV Hubbard St,11.489944903581264,12.156628787878788,11.341792929292929,88,396,484,0,484
Long & Irving Park,13.547481021394066,15.505434782608697,11.767523056653491,230,253,483,0,483
Sacramento Blvd & Franklin Blvd,12.313623789764872,14.486691542288558,11.476867816091954,134,348,231,251,482
Washtenaw Ave & Ogden Ave,18.086099585062243,19.516872427983536,17.361770833333335,162,320,153,329,482
N Clark St & W Elm St,8.641560283687939,9.1792253521126774,8.4087906504065053,142,328,470,0,470
Whipple/Irving Park,11.353876811594201,11.703155339805823,11.07060367454068,206,254,460,0,460
Dodge Ave & Main St,24.540228613569319,39.606702898550715,14.196082089552242,184,268,143,309,452
Damen Ave & Lake St,13.088913525498892,12.910020449897752,13.190162037037037,163,288,167,284,451
Conservatory Dr & Lake St,21.064344569288391,22.854807692307702,18.548018018018023,260,185,217,228,445
Campbell Ave & Irving Park Rd,10.680695718654432,9.76206896551724,11.290776081424939,174,262,436,0,436
Karlov Ave & Armitage Ave,23.855889145496533,24.034131736526948,23.743984962406014,167,266,143,290,433
Lincolnwood Dr & Central St,27.979961240310072,32.328184281842823,22.166576086956528,246,184,186,244,430
Kilbourn Ave & Milwaukee Ave,21.036780210867803,25.400720164609048,18.197590361445787,162,249,198,213,411
Hoyne Ave & 47th St,20.161341463414633,11.782649572649573,27.760620155038751,195,215,109,301,410
Cottage Grove Ave & 67th St,20.654383788254759,22.431264367816091,19.65574935400516,145,258,143,260,403
Stony Island Ave & 63rd St,23.831079931972788,32.703799654576862,15.22587939698492,193,199,83,309,392
State St & 95th St,17.751023017902813,22.383707025411066,11.601686507936508,223,168,172,219,391
Lincoln Ave & Balmoral Ave,14.213533507397734,12.453488372093023,15.10741469816273,129,254,383,0,383
Jeffery Blvd & 67th St,27.918062827225132,41.869835680751173,19.663263888888888,142,240,106,276,382
Public Rack - Hyde Park Blvd & 53rd St,22.34753086419752,24.423611111111111,21.233536585365854,132,246,378,0,378
Richmond St & Lincoln Ave,14.707709447415333,22.604361370716507,11.543133583021225,107,267,181,193,374
Public Rack - Woodlawn Ave & 63rd St N,5.5026793823796538,6.9242138364779873,4.925351213282247,106,261,367,0,367
Wolcott Ave & Fargo Ave,19.616620879120877,29.159871794871794,14.314814814814817,130,234,214,150,364
Rockwell St & Cermak Rd,13.042170329670331,11.266935483870965,13.959375000000001,124,240,364,0,364
MLK Jr Dr & 56th St,17.497658402203861,17.271404399323181,17.766164658634533,197,166,103,260,363
Kostner Ave & Wrightwood Ave,23.492685185185181,30.093700787401573,19.894706723891275,127,233,185,175,360
Burnham Greenway & 112th St,42.3419701213819,50.763278008298734,24.845977011494252,241,116,64,293,357
Kenneth Ave & Lawrence Ave,26.326512968299706,34.968531468531474,20.268627450980389,143,204,119,228,347
Princeton Ave & 47th St,12.765406976744185,18.091156462585033,8.7913705583756343,147,197,127,217,344
Western Ave & Lake St,14.004033041788148,13.359147869674187,14.412460317460319,133,210,272,71,343
Western Blvd & 48th Pl,15.148833819241981,10.939238095238096,19.533829365079363,175,168,162,181,343
Kedzie Ave & 21st St,22.453313840155946,23.752350427350429,21.363799283154126,156,186,182,160,342
Kenosha Ave & Wellington Ave,19.995634920634917,23.396253229974153,17.87640901771336,129,207,244,92,336
Springfield Ave & North Ave,24.504444444444445,32.768181818181816,16.240707070707071,165,165,111,219,330
Stony Island Ave & 71st St,18.836836518046709,35.794666666666664,13.515341701534172,75,239,62,252,314
Washtenaw Ave & Polk St,11.455021367521367,17.865370370370371,8.85623123123123,90,222,312,0,312
Keeler Ave & Carmen Ave,38.772615219721317,49.772905027932978,23.855555555555551,179,132,117,194,311
Public Rack - Christiana Ave & Belmont Ave,9.0234204793028319,8.7777372262773721,9.22258382642998,137,169,306,0,306
South Shore Dr & 74th St,35.42748633879782,41.811439842209076,27.494485294117656,169,136,109,196,305
Princeton Ave & Garfield Blvd,16.138666666666662,14.561515151515151,17.051754385964912,110,190,137,163,300
Indiana Ave & 40th St,17.791441441441446,19.785945945945947,14.467267267267264,185,111,107,189,296
Karlov Ave & Lawrence Ave,22.504024943310657,31.860471976401179,16.662707182320442,113,181,136,158,294
St Louis Ave & Foster Ave,21.436998854524635,27.12195512820513,18.275311942958997,104,187,132,159,291
Big Marsh Park,39.608563218390813,43.223349436392915,30.593373493975903,207,83,59,231,290
Eberhart Ave & 61st St,22.483621683967705,25.394522144522146,19.632534246575347,143,146,90,199,289
Jeffery Blvd & 71st St,20.783627797408716,29.085304659498213,16.720175438596488,93,190,116,167,283
Public Rack - Racine Ave & 109th Pl,9.48031914893617,8.9799999999999986,9.5398809523809511,30,252,282,0,282
State St & 54th St,18.334803921568625,22.174404761904768,15.647083333333335,112,160,117,155,272
Austin Blvd & Lake St,23.339365671641797,24.282799145299144,22.025297619047624,156,112,124,144,268
May St & 69th St,25.408364544319603,92.735294117647058,20.830133333333336,17,250,128,139,267
Stony Island Ave & 67th St,24.533333333333335,30.203987730061339,15.290166666666664,163,100,54,209,263
Washtenaw Ave & Peterson Ave,16.2588122605364,12.554166666666667,18.414242424242424,96,165,261,0,261
Lockwood Ave & Wrightwood Ave,16.979999999999997,25.882156862745095,12.656095238095238,85,175,168,92,260
Chicago State University,12.791241830065363,13.617190226876087,10.326302083333333,191,64,121,134,255
Public Rack - Langley Ave & 49th St,6.1943121693121688,5.87948717948718,6.2114365411436543,13,239,252,0,252
Union Ave & Root St,19.302523240371844,20.9406015037594,17.456214689265536,133,118,122,129,251
Central Ave & Chicago Ave,11.676199999999998,16.454263565891473,10.68365539452496,43,207,85,165,250
State St & 79th St,21.450133333333333,41.252380952380946,8.6828947368421066,98,152,89,161,250
Public Rack - Haft Ave & Milwaukee Ave,14.849595141700407,19.437222222222218,13.377629233511588,60,187,247,0,247
Eggleston Ave & 69th St,23.612724757952986,13.996327683615819,26.7301282051282,59,182,39,202,241
Millard Ave & 26th St,19.360900140646972,28.465500000000002,12.71520681265207,100,137,116,121,237
Exchange Ave & 79th St,28.107980225988705,41.682575757575769,22.8378431372549,66,170,62,174,236
Virginia Ave & Catalpa Ave,12.367450142450144,12.748645833333335,11.543243243243241,160,74,234,0,234
Western Ave & 111th St,20.42827635327636,19.618295739348369,21.494884488448847,133,101,68,166,234
Baltimore Ave & 87th St,17.957868383404861,24.860238095238095,14.993660531697341,70,163,147,86,233
Sacramento Blvd & Fulton Ave,10.331962481962481,11.200144927536231,9.4712643678160919,115,116,231,0,231
Stony Island Ave & 75th St,22.10599415204678,36.749549549549542,19.269284467713785,37,191,39,189,228
California Ave & 26th St,27.500881057268721,45.587222222222223,21.002794411177646,60,167,115,112,227
Kostner Ave & Bryn Mawr Ave,35.6547619047619,40.1298309178744,28.473837209302328,138,86,64,160,224
Rainbow - Beach,28.953153153153153,33.421581196581194,26.532754629629629,78,144,39,183,222
MLK Jr Dr & 63rd St,18.028205128205126,20.46494252873563,13.379166666666668,145,76,123,98,221
Ashland Ave & 50th St,16.507458143074583,30.356363636363632,11.863008130081301,55,164,127,92,219
Calumet Park,33.375840978593274,33.777900552486194,31.409009009009011,181,37,41,177,218
Kilbourn Ave & Roscoe St,18.677342549923193,20.690769230769224,15.668773946360147,130,87,89,128,217
Damen Ave & Pershing Rd,25.775576036866354,32.657851239669426,17.101041666666671,121,96,72,145,217
Fairfield Ave & Roosevelt Rd,24.354049844236762,22.27729166666667,25.593905472636813,80,134,84,130,214
Perry Ave & 69th St,21.456996855345906,20.05103244837758,23.061784511784506,113,99,40,172,212
Fairfield Ave & Pratt Blvd,18.314465408805031,24.735992907801414,13.199011299435027,94,118,65,147,212
Kedvale Ave & Peterson Ave,19.685167464114837,25.831521739130434,17.950613496932512,46,163,165,44,209
Shields Ave & 43rd St,11.72235576923077,20.794017094017093,9.6288954635108475,39,169,84,124,208
Yates Blvd & 75th St,20.564108910891093,22.018750000000004,16.142000000000003,152,50,61,141,202
Weekend Night Parking Area A,9.6392499999999988,9.2829710144927535,9.942746913580244,92,108,200,0,200
Ashland Ave & Pershing Rd,16.662626262626262,14.712841530054646,17.530778588807788,61,137,22,176,198
Kilbourn Ave & Belden Ave,20.872979797979795,26.043965517241379,18.730714285714285,58,140,119,79,198
Buckingham - Fountain,30.848214285714292,32.053002070393369,25.306190476190473,161,35,44,152,196
Central Park Ave & Ardmore Ave,25.652721088435374,27.090235690235684,24.185567010309285,99,97,32,164,196
Walden Pkwy & 100th St,25.503589743589739,28.972058823529412,21.6994623655914,102,93,86,109,195
Dan Ryan Woods & 83rd St,32.206735751295348,34.156827309236959,20.217283950617283,166,27,23,170,193
Western Ave & Ardmore Ave,13.667888307155323,14.153658536585368,12.789215686274511,123,68,191,0,191
Wentworth Ave & 63rd St,16.540350877192981,21.280412371134023,11.596415770609319,97,93,80,110,190
Michigan Ave & 71st St,9.4821869488536183,17.688541666666666,8.7232177263969159,16,173,79,110,189
Commercial Ave & 83rd St,36.832716049382718,72.21982758620689,21.16513994910941,58,131,81,108,189
Austin Blvd & Madison St,44.950177304964541,66.6381188118812,19.772222222222226,101,87,65,123,188
Narragansett Ave & Wrightwood Ave,24.265775401069508,26.072557471264361,21.313849765258219,116,71,112,75,187
Calumet Ave & 71st St,13.381810035842296,25.230496453900709,9.3754196642685841,47,139,66,120,186
Halsted St & 96th St,13.954144144144145,28.3463768115942,11.910802469135803,23,162,70,115,185
Halsted St & 63rd St,25.713134057971015,41.216875,13.787179487179486,80,104,35,149,184
Halsted St & 47th Pl,18.071376811594202,20.988251366120217,16.624796747967483,61,123,52,132,184
Marshfield Ave & 44th St,29.760989010989004,18.44977168949772,37.336391437308869,73,109,72,110,182
Stony Island Ave & 64th St,25.95333333333334,33.5062091503268,16.076495726495725,102,78,36,144,180
Public Rack - Milwaukee Ave & Diversey Ave,10.816014897579144,10.511904761904763,10.954471544715448,56,123,179,0,179
Kostner Ave & Devon Ave,33.054331450094175,35.193532338308458,26.387984496124034,134,43,41,136,177
Kedzie Ave & 57th St,14.134659090909095,12.001941747572817,17.143835616438356,103,73,131,45,176
Public Rack - Kostner Ave & Armitage Ave,17.625189393939387,20.11880341880342,15.640476190476189,78,98,176,0,176
California & 16th St,14.512095238095235,13.238738738738736,16.720572916666665,111,64,175,0,175
Public Rack - California Ave & Cortez St,10.957279693486589,10.167136150234743,11.501941747572817,71,103,174,0,174
Lamon Ave & Armitage Ave,18.2247591522158,13.657870370370372,21.480363036303629,72,101,106,67,173
Narragansett & Wrightwood,10.736434108527131,12.444158075601374,8.5277777777777786,97,75,172,0,172
Kostner Ave & Adams St,15.78392156862745,30.202222222222229,14.388602150537634,15,155,109,61,170
Weekend Night Parking Area B,14.745069033530569,16.051960784313724,13.422619047619046,85,84,169,0,169
Public Rack - Hollywood Park,15.354590818363269,14.746825396825397,15.442009132420093,21,146,167,0,167
Pulaski & Ann Lurie Pl,7.769898989898989,8.8375,7.4282666666666648,40,125,165,0,165
Narragansett Ave & School St,18.001515151515154,8.99009009009009,20.606380208333331,37,128,165,0,165
North Boundary Park,25.206767676767672,28.395528455284552,22.056425702811243,82,83,103,62,165
Public Rack - Western Ave & Devon Ave,15.794715447154472,11.727777777777778,17.0636,39,125,164,0,164
Prospect Sq & 91st St,45.07113821138212,66.421851851851855,19.104054054054057,90,74,50,114,164
Morgan St & Pershing Rd,15.3299591002045,23.011111111111109,8.2813725490196077,78,85,52,111,163
Public Rack - Harold Washington Park,16.758179959100204,15.738120567375889,18.147826086956517,94,69,163,0,163
Public Rack - Hamlin Ave & Fullerton Ave,10.379062499999998,9.7089080459770116,10.760130718954249,58,102,160,0,160
Public Rack - Milwaukee Ave & Higgins Ave,11.353958333333333,9.6850694444444443,12.069196428571427,48,112,160,0,160
Long Ave & Belmont Ave,15.694234800838576,16.4640562248996,14.853508771929823,83,76,125,34,159
Sacramento Ave & Lunt Ave,36.771518987341778,46.520877192982454,22.070105820105823,95,63,69,89,158
Milwaukee Ave & Ainslie St,18.291507430997878,16.690151515151513,19.452930402930402,66,91,80,77,157
Public Rack - Monticello Ave & Belmont Ave,15.285149572649575,14.83515625,15.598188405797105,64,92,156,0,156
Artesian Ave & 55th St,20.148602150537627,23.150806451612898,18.147132616487458,62,93,54,101,155
Komensky Ave & 31st St,10.203870967741937,13.321774193548388,8.1252688172043,62,93,155,0,155
California Ave & Touhy Ave,28.409784946236567,42.307729468599035,17.259108527131779,69,86,59,96,155
Central Park & Augusta Blvd,17.41,18.023484848484848,17.166816816816819,44,111,155,0,155
Public Rack - Pulaski Rd & Armitage Ave,11.66774891774892,16.972413793103446,10.437066666666672,29,125,154,0,154
Cottage Grove Ave & 83rd St,20.141885964912277,21.709999999999997,19.756284153005463,30,122,71,81,152
Vernon Ave & 75th St,21.549116997792492,12.846527777777776,23.193700787401571,24,127,27,124,151
Public Rack - Milwaukee Ave & Haussen Ct,11.393111111111113,9.6227011494252874,12.509239130434782,58,92,150,0,150
Ashland Ave & McDowell Ave,20.446111111111112,24.20086206896552,18.078985507246376,58,92,57,93,150
Public Rack - Spaulding Ave & Evergreen Ave,11.383666666666665,11.333333333333334,11.401351351351348,39,111,150,0,150
Albany Ave & 26th St,30.251666666666662,40.457478632478633,19.195370370370366,78,72,50,100,150
Washtenaw Ave & Madison St,10.158445945945946,5.7685897435897431,11.093989071038255,26,122,148,0,148
Hamlin Ave & Grand Ave,19.77902494331066,12.589906103286383,26.495175438596494,71,76,147,0,147
Kilpatrick Ave & Parker Ave,13.266438356164381,13.606981981981983,12.916435185185183,74,72,146,0,146
Public Rack - Rockwell & Division,10.720254629629629,11.370930232558139,10.443234323432343,43,101,144,0,144
Public Rack - Hamlin Ave & Montrose Ave,8.48927738927739,9.9839622641509429,7.6090740740740745,53,90,143,0,143
Public Rack - Hyde Park Blvd & 55th St,11.31095571095571,14.598484848484846,9.2562499999999979,55,88,143,0,143
State St & Pershing Rd,33.13461538461538,60.04677419354838,12.535185185185185,62,81,63,80,143
Public Rack - Throop St & 58th St,13.092605633802822,7.8051282051282049,14.277729885057473,26,116,142,0,142
Buckingham Fountain (Columbus/Balbo),36.766314553990618,40.7497267759563,12.4675,122,20,36,106,142
Cicero Ave & Roscoe Ave,22.054107981220657,22.889417989417986,21.387974683544307,63,79,95,47,142
Western Ave & 104th St,44.507380952380949,66.092521367521371,17.351881720430111,78,62,47,93,140
Wrigley Events Parking Area,12.489808153477217,12.014912280701754,13.062698412698412,76,63,139,0,139
Public Rack - Washtenaw Ave & Devon Ave,12.431280193236717,12.250476190476189,12.492718446601941,35,103,138,0,138
Grace St & Cicero Ave,31.254347826086953,17.53782051282051,39.548062015503874,52,86,67,71,138
Lawndale Ave & 111th St,41.375362318840565,45.694444444444443,17.311904761904763,117,21,11,127,138
Lowell Ave & Armitage,23.548175182481756,26.245312499999994,21.183561643835613,64,73,70,67,137
Hale Ave & 107th St,27.846446078431367,38.150843881856538,13.564912280701755,79,57,61,75,136
Midway Orange Line,33.651838235294122,37.076072607260727,23.770476190476195,101,35,23,113,136
Kedzie Ave & Roosevelt Rd,26.209259259259259,43.0514880952381,14.270464135021095,56,79,54,81,135
Shabbona Park,18.928855721393038,19.060289855072465,18.133333333333333,115,19,91,43,134
Burnham Greenway & 105th St,24.104353233830853,36.230423280423295,13.344600938967139,63,71,40,94,134
Fairfield Ave & 44th St,16.972601010101009,18.670370370370371,14.276143790849671,81,51,96,36,132
Halsted St & 78th St,21.982828282828283,60.12916666666667,15.17098214285714,20,112,76,56,132
Public Rack - Kedzie Ave & Argyle St,10.490151515151517,14.8859649122807,9.75103244837758,19,113,132,0,132
California Ave & Marquette Rd,25.040404040404034,27.0315873015873,17.296913580246912,105,27,28,104,132
Kedzie Ave & 110th St,26.991984732824427,29.252064896755162,12.803703703703706,113,18,16,115,131
Commercial Ave & 130th St,28.91577608142493,29.399462365591397,20.347619047619048,124,7,80,51,131
Lavergne Ave & Fullerton Ave,20.964358974358973,22.731837606837608,18.313141025641027,78,52,65,65,130
Harlem & Irving Park,14.007622739018085,13.216145833333336,16.310101010101011,96,33,129,0,129
Central Park Ave & 24th St,24.439713541666659,30.3021568627451,12.851162790697673,85,43,64,64,128
Kedzie Ave & Redfield Dr,30.542650918635168,32.058333333333344,19.225555555555552,112,15,36,91,127
Wabash Ave & 87th St,22.884933333333333,37.160784313725493,13.046171171171173,51,74,33,92,125
Hoyne Ave & 34th St,15.0776,19.692635658914732,12.657520325203251,43,82,57,68,125
Cicero Ave & Lake St,25.932666666666666,16.793333333333333,35.833611111111118,65,60,38,87,125
Komensky Ave & 55th St,8.9342741935483883,8.3751207729468611,9.6357575757575749,69,55,124,0,124
Bernard St & Peterson Ave,32.555327868852459,45.571751412429386,20.365343915343917,59,63,22,100,122
Rockwell St & Archer Ave\t,15.558060109289618,13.342333333333332,17.096759259259258,50,72,55,67,122
Lawler Ave & 50th St,20.052322404371587,22.346401515151513,14.114705882352943,88,34,102,20,122
Lawndale Ave & 30th St,10.357988980716252,10.308024691358025,10.773076923076925,108,13,95,26,121
Kildare Ave & North Ave,33.758815426997238,48.0221153846154,23.009661835748794,52,69,43,78,121
Lamon Ave & Belmont Ave,11.229444444444443,9.8768115942028984,13.059477124183008,69,51,120,0,120
Central Ave & Lake St,21.545000000000005,22.486928104575167,20.8487922705314,51,69,47,73,120
Kedzie Ave & Harrison St,22.714166666666664,33.751960784313717,14.555797101449278,51,69,42,78,120
Central Ave & Altgeld St,18.387083333333337,22.516666666666666,15.820045045045045,46,74,60,60,120
Cicero Ave & Wrightwood Ave,14.770416666666668,15.796491228070176,14.29491869918699,38,82,82,38,120
St Louis Ave & 59th St,22.000980392156862,39.529931972789115,9.7307142857142868,49,70,92,27,119
Halsted St & 111th St,8.4232492997198865,30.369444444444447,7.2579646017699115,6,113,114,5,119
Kilpatrick Ave & Grand Ave,20.170728291316529,21.637083333333337,19.428270042194093,40,79,73,46,119
Austin Blvd & Chicago Ave,24.14957983193278,24.595736434108527,22.986868686868686,86,33,47,72,119
Sacramento Ave & Pratt Blvd,26.573446327683619,35.692622950819661,16.814327485380112,61,57,37,81,118
Milwaukee Ave & Agatite Ave,26.244017094017082,20.821249999999996,29.061038961038964,40,77,22,95,117
Public Rack - Lawndale Ave & Diversey Ave,13.593162393162395,13.38015873015873,13.639756944444445,21,96,117,0,117
Laramie Ave & Irving Park Rd,20.086039886039888,19.865708812260539,20.725,87,30,78,39,117
Pulaski Rd & Lake St,23.804558404558406,25.77676767676768,21.252287581699349,66,51,38,79,117
Lexington St & California Ave,21.331034482758614,34.375793650793639,13.927252252252252,42,74,29,87,116
Oak Park & Wellington,15.494683908045976,19.114971751412426,11.747368421052631,59,57,116,0,116
Houston Ave & 92nd St,18.008620689655171,26.963768115942027,12.123809523809525,46,70,66,50,116
Leclaire Ave & Belmont Ave,22.178405797101448,25.6995238095238,16.701111111111111,70,45,58,57,115
Public Rack - Cumberland & Catherine,18.721014492753625,32.361111111111114,14.53598484848485,27,88,115,0,115
Artesian Ave & Marquette Rd,23.353043478260876,30.12539682539682,19.456621004566209,42,73,23,92,115
Narragansett & Irving Park,11.617109144542775,12.156666666666668,11.006289308176102,60,53,113,0,113
Central Park Blvd & 5th Ave,35.722418879056043,45.651633986928104,27.554838709677416,51,62,44,69,113
Halsted St & 51st St,17.305309734513276,16.340860215053763,17.669918699186994,31,82,37,76,113
Kedzie Ave & 24th St,39.063095238095237,45.092405063291132,24.62929292929293,79,33,57,55,112
Long Ave & Belden Ave,14.09060606060606,7.893859649122807,17.361111111111107,38,72,110,0,110
Avenue O & 118th St,23.2939393939394,32.179943502824862,13.0140522875817,59,51,39,71,110
Ewing Ave & Burnham Greenway,26.68796296296296,39.784294871794863,14.527083333333334,52,56,66,42,108
Meade Ave & Addison St,23.305607476635512,39.019379844961236,12.747916666666667,43,64,92,15,107
Public Rack - Washington Park Ct & 51st St,14.676947040498442,14.759803921568626,14.356818181818181,85,22,107,0,107
Cicero Ave & Grace St,15.750786163522012,15.603571428571428,15.803632478632474,28,78,106,0,106
Rockwell St & 57th St,15.60738993710692,14.313387978142076,17.36148148148148,61,45,55,51,106
Dauphin Ave & 87th St,22.996698113207547,22.352469135802469,23.665705128205126,54,52,31,75,106
Halsted St & 69th St,13.545714285714286,11.105555555555556,15.375833333333333,45,60,26,79,105
Karlov Ave & Madison St,26.725801282051286,43.072916666666664,12.713988095238092,48,56,34,70,104
Harding Ave & Division St,30.438461538461535,31.413020833333327,28.879166666666666,64,40,35,69,104
Public Rack - Pulaski Rd & 44th St,8.4280448717948726,9.45943396226415,7.356209150326797,53,51,104,0,104
Central Park Ave & Ohio St,7.2358974358974368,7.1053191489361707,8.4633333333333329,94,10,104,0,104
Public Rack - Kostner Ave & Diversey Ave,9.641346153846154,11.335294117647061,9.3103448275862082,17,87,104,0,104
Central Ave & Madison St,23.028640776699032,20.077083333333334,26.545390070921989,56,47,39,64,103
Summit Ave & 86th St,20.130582524271841,24.866666666666671,19.127647058823531,18,85,12,91,103
Loomis Blvd & 84th St,16.289705882352944,13.84230769230769,36.536363636363632,91,11,25,77,102
St Louis Ave & Norman Bobbins Ave,8.3011437908496735,7.7469135802469138,10.43888888888889,81,21,102,0,102
Evans Ave & 75th St,25.745499999999996,23.058974358974357,26.689414414414411,26,74,11,89,100
Phillips Ave & 79th St,43.397166666666664,43.881818181818176,42.804814814814812,55,45,37,63,100
Kostner Ave & Belmont Ave,31.843265993265991,27.023148148148145,37.627407407407411,54,45,36,63,99
Public Rack - Lafayette Ave & 95th St,10.401346801346802,9.8017857142857157,10.637793427230045,28,71,99,0,99
Public Rack - Wilbur Wright College South,15.478451178451179,13.814942528735632,16.167619047619048,29,70,99,0,99
Springfield Ave & 71st St,17.146598639455782,15.95281124497992,23.752222222222219,83,15,54,44,98
Kilbourn Ave & Diversey Ave,23.34347079037801,29.913141025641025,15.751851851851853,52,45,60,37,97
Woodlawn Ave & 75th St,15.304123711340205,15.89327485380117,14.464583333333334,57,40,26,71,97
California Ave & 71st St,20.008854166666662,28.612499999999994,11.405208333333336,48,48,11,85,96
Sacramento Ave & 25th St,13.539409722222224,13.56823899371069,13.503875968992247,53,43,96,0,96
Central Ave & Roscoe St,24.759122807017537,24.638205128205126,25.021111111111111,65,30,42,53,95
Central Park Ave & Washington Blvd,24.918421052631583,29.208490566037746,19.504761904761903,53,42,28,67,95
Central Ave & Parker Ave,14.65701754385965,12.916666666666666,15.767241379310347,37,58,95,0,95
Harding Ave & 26th St,9.2858422939068088,10.633647798742139,7.5,53,40,76,17,93
Western Ave & 43rd St,28.291756272401429,29.71590909090909,27.012925170068023,44,49,23,70,93
Vincennes Ave & 104th St,34.04910394265233,75.02634408602151,13.560483870967742,31,62,28,65,93
Public Rack - California Ave & Devon Ave - NE,17.107608695652171,19.743333333333332,15.832258064516129,30,62,92,0,92
Harlem Ave & Irving Park Rd,27.403985507246375,31.242328042328044,19.065517241379311,63,29,47,45,92
Public Rack - Lowell Ave & Elston Ave,13.563186813186812,8.2316666666666656,31.334920634920636,70,21,91,0,91
MLK Jr Dr & 83rd St,17.336630036630034,22.416666666666668,15.996064814814817,19,72,10,81,91
Tripp Ave & 65th St,21.867399267399271,22.666244725738398,16.608333333333334,79,12,58,33,91
Nordica Ave & Medill Ave,12.129444444444447,11.55904761904762,12.492424242424242,35,55,56,34,90
Public Rack - Milwaukee Ave & Catalpa Ave,10.514999999999999,13.512499999999996,9.86689189189189,16,74,90,0,90
Loomis St & 89th St,10.38925925925926,6.8155844155844161,31.556410256410263,77,13,15,75,90
Doty Ave & 111th St,27.597940074906369,29.603896103896105,14.726388888888888,77,12,41,48,89
Jeffery Blvd & 76th St,14.6689138576779,13.082485875706213,17.788888888888888,59,30,17,72,89
Kedzie Ave & 52nd St,10.545265151515149,10.403076923076924,10.947101449275362,65,23,64,24,88
Damen Ave & Coulter St,32.226704545454552,50.330797101449278,12.398412698412699,46,42,44,44,88
Public Rack - Olmstead Ave & Oliphant Ave,14.754166666666665,23.207894736842103,12.426328502415458,19,69,88,0,88
Public Rack - Midway Orange Line,9.7017241379310342,7.78688524590164,14.194230769230767,61,26,87,0,87
Public Rack - Kinzua Ave & Devon Ave,11.89770114942529,13.740860215053763,10.877380952380953,31,56,87,0,87
Public Rack - Walden Pkwy & 103rd St,8.7969348659003845,9.4690476190476183,8.4779661016949142,28,59,87,0,87
Springfield Ave & 47th St,6.9800766283524913,6.847716894977169,7.6702380952380942,73,14,87,0,87
Public Rack - Kimbark Ave & 63rd St,4.0249042145593865,3.9555555555555553,4.0329059829059837,9,78,87,0,87
Kenneth Ave & 50th St,8.95156862745098,9.2416666666666671,7.9438596491228077,66,19,85,0,85
Sayre & Diversey,10.980588235294118,9.7607594936708857,27.041666666666668,79,6,85,0,85
University Ave & 65th St,24.740476190476194,31.01,19.040909090909093,40,44,30,54,84
Stewart Ave & 63rd St,25.105823293172694,49.843010752688173,10.358653846153846,31,52,10,73,83
Hegewisch Metra Station,35.422357723577228,35.429746835443034,35.227777777777781,79,3,35,47,82
Public Rack - Milwaukee Ave & Kennedy Expy,10.136991869918699,7.9568627450980394,10.70717948717949,17,65,82,0,82
Public Rack - Nagle Ave & Belmont Ave,20.163211382113822,7.8743589743589739,22.478502415458934,13,69,82,0,82
Francisco Ave & 47th St,18.7010162601626,13.773643410852713,24.133760683760684,43,39,58,24,82
Indiana Ave & 103rd St,16.502263374485597,16.0025,17.93015873015873,60,21,38,43,81
Public Rack - Campbell Ave & Pratt Blvd,10.374485596707817,11.342857142857145,9.8628930817610065,28,53,81,0,81
Meade Ave & Fullerton Ave,36.079629629629622,25.066025641025639,55.828160919540224,52,29,40,41,81
Laramie Ave & Madison St,16.469341563786006,19.404575163398693,11.479444444444445,51,30,38,43,81
Kedzie Ave & 66th Pl,27.657916666666669,36.642,12.684444444444445,50,30,21,59,80
Public Rack - Calumet Ave & 51st St,7.4722916666666661,7.9283950617283949,7.2399371069182381,27,53,80,0,80
Marmora Ave & Irving Park Rd,32.631458333333327,36.546045197740114,21.633333333333336,59,21,40,40,80
Damen Ave & 87th St,69.20886075949366,82.136290322580649,22.06176470588235,62,17,16,63,79
Steelworkers Park,22.143803418803415,21.128169014084502,32.445238095238096,71,7,76,2,78
Halsted St & 73rd St,14.051282051282053,10.852083333333333,22.194696969696974,56,22,12,66,78
Major Ave & Addison St,14.823504273504273,20.571491228070176,9.3629166666666688,38,40,38,40,78
Vernon Ave & 79th St,17.2495670995671,34.101333333333336,9.1477564102564131,25,52,28,49,77
Latrobe Ave & Chicago Ave,8.418181818181818,15.020512820512819,7.0770833333333325,13,64,17,60,77
Cottage Grove Ave & 111th Pl,27.316883116883119,29.00625,24.520689655172415,48,29,14,63,77
Mason Ave & Belmont Ave,14.853030303030302,12.391666666666667,18.927011494252874,48,29,77,0,77
Public Rack - Rockwell Ave & Touhy Ave ,9.4228070175438585,10.785185185185185,8.6721088435374138,27,49,76,0,76
Linder Ave & Montrose Ave,23.390222222222221,33.810360360360356,13.244298245614035,37,38,41,34,75
Clyde Ave & 87th St,27.68911111111111,29.549371069182389,23.207575757575757,53,22,42,33,75
Greenwood Ave & 97th St,16.875777777777778,19.338304093567249,9.07777777777778,57,18,28,47,75
Kildare Ave & Division St,15.495270270270272,17.468439716312055,12.060493827160492,47,27,64,10,74
St Louis Ave & Norman Bobbins Pl,12.17252252252252,12.045454545454545,13.220833333333333,66,8,42,32,74
Kostner Ave & 63rd St,21.502702702702702,18.738888888888887,33.347619047619041,60,14,39,35,74
Public Rack - Spaulding Ave & North Ave,14.517567567567566,10.888709677419353,17.13372093023256,31,43,74,0,74
Richmond St & 59th St,20.283108108108113,21.0775956284153,16.555128205128206,61,13,42,32,74
Harlem Ave & Bloomingdale Ave,23.156621004566208,25.311666666666671,20.544444444444441,40,33,51,22,73
Western Ave & 28th St,17.671461187214611,13.451851851851849,24.452976190476189,45,28,52,21,73
Laramie Ave & Addison St,30.359589041095894,28.977777777777778,33.012666666666668,48,25,25,48,73
Monticello Ave & Chicago Ave,15.664611872146118,21.419230769230769,9.0637254901960791,39,34,57,16,73
Public Rack - Drake Ave & Leland Ave,11.124657534246577,16.314583333333331,10.485897435897439,8,65,73,0,73
Vernon Ave & 107th St,33.09282407407408,33.06830985915493,34.833333333333336,71,1,50,22,72
Lamon Ave & Chicago Ave,15.55902777777778,15.464655172413789,15.950000000000001,58,14,65,7,72
Kildare Ave & 55th St,16.47939814814815,16.557291666666664,15.85625,64,8,43,29,72
Albany Ave & 16th St,17.387268518518518,16.56176470588235,19.392063492063489,51,21,72,0,72
Public Rack - Milwaukee Ave & Culyer Ave,9.8082159624413148,13.186309523809523,7.6085271317829459,28,43,71,0,71
Public Rack - Harper Ave & 63rd St,18.343896713615024,24.84810606060606,7.7444444444444445,44,27,71,0,71
Laramie Ave & Kinzie St,29.261971830985917,26.8265625,31.260256410256414,32,39,20,51,71
Public Rack - Lavergne & Lawrence,18.196666666666669,12.615555555555556,19.718787878787875,15,55,70,0,70
Grace St & Central Ave,26.90190476190476,38.4328125,17.191666666666663,32,38,37,33,70
Cicero Ave & Quincy St,16.920952380952379,24.313218390804597,11.692276422764227,29,41,29,41,70
Ellis Ave & 83rd St,37.462380952380954,47.087152777777781,16.46287878787879,48,22,31,39,70
Public Rack - Forest Glen & Peterson,26.432380952380957,28.794444444444441,26.083879781420766,9,61,70,0,70
Maplewood Ave & 59th St,13.231642512077293,12.645454545454546,13.768981481481481,33,36,69,0,69
Roscoe & Harlem,8.2050724637681167,6.8631720430107519,20.090476190476192,62,7,69,0,69
Oglesby Ave & 100th St,18.789855072463769,23.011111111111113,17.901169590643278,12,57,40,29,69
Artesian Ave & 71st St,13.222303921568628,12.237398373983741,14.7179012345679,41,27,6,62,68
Elizabeth St & 47th St,22.983582089552236,23.212777777777781,22.797747747747749,30,37,15,52,67
Meade Ave & Diversey Ave,21.377611940298504,23.680476190476192,18.858854166666671,35,32,63,4,67
Francisco Ave & Hollywood Ave,13.35277777777778,11.75609756097561,15.97133333333333,41,25,66,0,66
Major Taylor Trail & 115th St,43.347727272727276,63.472368421052622,16.035714285714285,38,28,33,33,66
Ashland Ave & 63rd St,16.421717171717173,14.755701754385965,18.682738095238097,38,28,12,54,66
Stewart Ave & 83rd St,19.397179487179486,21.105666666666664,13.702222222222222,50,15,14,51,65
Dauphin Ave & 103rd St,26.881282051282049,28.218390804597696,15.802380952380952,58,7,8,57,65
North Ave & New England Ave,29.148177083333334,20.127941176470589,39.371111111111105,34,30,64,0,64
Central Ave & Harrison St,25.386197916666664,29.026241134751771,15.322549019607841,47,17,35,29,64
Public Rack - Holbrook St & Milwaukee Ave,67.015364583333337,16.102777777777778,72.28218390804598,6,58,64,0,64
Pulaski Rd & Congress Pkwy,54.224218750000006,79.440090090090081,19.669135802469139,37,27,7,57,64
Damen Ave & 81st St,27.816137566137566,34.8060975609756,14.789393939393939,41,22,34,29,63
Kildare Ave & 47th St,10.127513227513226,14.093939393939394,5.764444444444444,33,30,57,6,63
Whipple St & Roosevelt Rd,22.641534391534396,31.809139784946236,13.760416666666668,31,32,63,0,63
California Ave & 41st St,18.585714285714285,18.090686274509803,19.166091954022988,34,29,29,34,63
Kildare Ave & 26th St,28.790053763440863,31.202836879432628,21.23,47,15,49,13,62
Lavergne Ave & Lawrence Ave,20.072849462365589,10.568055555555556,22.353999999999996,12,50,36,26,62
Public Rack - Prairie Ave & Garfield Blvd S,12.702419354838709,22.959649122807019,8.17015503875969,19,43,62,0,62
Merrimac Park,22.412634408602148,17.369767441860461,33.825438596491225,43,19,28,34,62
Sayre Ave & Diversey Ave,18.583870967741934,20.880072463768112,11.982291666666667,46,16,41,21,62
Albany Ave & Douglas Blvd,10.490053763440864,10.246124031007753,11.042105263157897,43,19,52,10,62
East End Ave & 87th St,23.106989247311834,20.54950980392157,26.2125,34,28,12,50,62
Campbell Ave & 51st St,17.729508196721316,15.15921985815603,26.358333333333334,47,14,43,18,61
Lawler Ave & North Ave,22.942622950819676,22.482142857142854,23.079787234042552,14,47,11,50,61
Public Rack - Avers & Lawrence,13.712222222222222,10.967391304347824,15.418468468468468,23,37,60,0,60
Halsted St & 56th St,14.47583333333333,14.8325,13.7625,40,20,31,29,60
Martin Luther King Dr & 111th St,4.9569444444444439,5.7313333333333336,4.4038095238095245,25,35,60,0,60
Stony Island Ave & South Chicago Ave,25.290277777777781,36.347727272727269,18.888596491228068,22,38,12,48,60
Kedzie Ave & 45th St,5.775706214689265,5.115384615384615,5.96231884057971,13,46,59,0,59
Scottsdale Park,26.118644067796602,23.547163120567369,36.190277777777773,47,12,4,55,59
Menard Ave & Lawrence Ave,30.412356321839074,30.597619047619048,30.239444444444441,28,30,20,38,58
Seeley Ave & Garfield Blvd,14.921551724137933,19.459523809523812,10.686111111111112,28,30,23,35,58
Western Ave & 79th St,24.072701149425288,30.725862068965519,17.419540229885058,29,29,18,40,58
Kostner Ave & Lake St,26.165517241379312,29.820833333333333,18.042592592592595,40,18,25,33,58
Mango Ave & Diversey Ave,42.764080459770121,74.977777777777774,14.70698924731183,27,31,15,43,58
Narragansett Ave & McLean Ave,22.076315789473679,25.919892473118281,17.493589743589741,31,26,33,24,57
Torrence Ave & 126th Pl,10.216374269005851,10.064545454545456,14.391666666666667,55,2,23,34,57
Racine Ave & Garfield Blvd,36.25204678362573,31.095614035087717,46.564912280701748,38,19,30,27,57
Harlem Ave & Grace St,26.372222222222224,28.274113475177305,17.433333333333334,47,10,38,19,57
Damen Ave & 33rd St,9.2888888888888879,8.6079365079365076,9.68611111111111,21,36,57,0,57
California Ave & 36th St,14.136904761904763,13.80787037037037,14.729166666666666,36,20,36,20,56
Ashland Ave & 66th St,41.215178571428559,20.85698924731183,66.459333333333319,31,25,29,27,56
Pershing Rd & Sacramento Ave,12.587797619047619,12.479251700680271,13.347619047619046,49,7,35,21,56
Avenue O & 134th St,41.438690476190473,44.111111111111107,14.18,51,5,14,42,56
Ashland Ave & Garfield Blvd,25.416369047619053,35.383333333333326,16.136781609195403,27,29,17,39,56
Wood St & 33rd St,22.901785714285715,30.894230769230766,15.975,26,30,12,44,56
Damen Ave & 74th St,14.612424242424241,16.993243243243242,9.71851851851852,37,18,18,37,55
Marshfield Ave & 59th St,19.062424242424242,30.01594202898551,11.189583333333331,23,32,25,30,55
Public Rack - Avers Ave & Irving Park Rd,13.424242424242426,15.51969696969697,12.027272727272727,22,33,55,0,55
Greenwood Ave & 79th St,22.204242424242423,24.406565656565657,18.900757575757574,33,22,7,48,55
Stony Island Ave & 82nd St,18.288787878787875,11.149509803921569,29.847619047619048,34,21,10,45,55
Public Rack - Irving Park Rd & Leclaire Ave,10.369753086419754,6.8808333333333334,12.42205882352941,20,34,54,0,54
Wabash Ave & 83rd St,23.968827160493831,45.056666666666665,5.7896551724137924,25,29,5,49,54
Damen Ave & 59th St,20.927777777777784,21.391111111111112,20.348611111111108,30,24,9,45,54
Granville Ave & Pulaski Rd,23.679012345679016,31.048039215686277,20.293243243243246,17,37,16,38,54
Marmora Ave & Belmont Ave,23.773899371069184,24.766239316239318,21.009523809523809,39,14,6,47,53
State St & 76th St,15.498113207547167,9.61111111111111,19.361458333333335,21,32,12,41,53
Cottage Grove Ave & 71st St,56.158490566037734,72.01761904761905,25.321296296296293,35,18,9,44,53
Public Rack - Western Blvd & 49th St,8.8778846153846143,8.0638095238095229,10.553921568627452,35,17,52,0,52
Greenwood Ave & 91st St,27.11538461538462,27.035714285714281,28.416666666666668,49,3,15,37,52
Kildare Ave & Chicago Ave,19.475320512820513,19.997727272727271,16.602083333333333,44,8,44,8,52
Harding Ave & 31st St,14.778431372549019,14.416279069767445,16.724999999999998,43,8,26,25,51
Central Ave & Wellington Ave,11.220588235294116,12.764942528735633,9.1848484848484837,29,22,32,19,51
Constance Ave & 95th St,67.7764705882353,86.901428571428582,25.940625,35,16,18,33,51
Kilbourn & Belden,17.398366013071897,19.53115942028985,15.646428571428574,23,28,51,0,51
21st St & Pulaski Rd,15.025666666666666,16.38978494623656,12.8,31,19,38,12,50
Pulaski Rd & 60th St,7.7573333333333334,7.604166666666667,8.37,40,10,50,0,50
Public Rack - Kedvale Ave & 63rd St W,10.633000000000001,17.510714285714286,7.958333333333333,14,36,50,0,50
Public Rack - Penn Elementary School / KIPP Ascend Middle School,17.213333333333331,24.86538461538461,14.524774774774775,13,37,50,0,50
Cottage Grove Ave & 78th St,50.635714285714279,85.520666666666656,14.297222222222221,25,24,15,34,49
Lavergne Ave & Division St,15.789455782312924,19.953472222222224,11.792,24,25,44,5,49
Kenton Ave & Madison St,28.620068027210881,45.223188405797096,13.932692307692308,23,26,11,38,49
Orange & Addison,25.111904761904764,26.000387596899223,18.744444444444444,43,6,49,0,49
Public Rack - Milwaukee Ave & School St,11.468707482993198,9.4323529411764682,12.550520833333334,17,32,49,0,49
Public Rack - Western Ave & 96th St,9.9462585034013582,11.1,9.8437037037037012,4,45,49,0,49
St. Louis & 71st St,36.673958333333331,38.475185185185182,9.6555555555555568,45,3,11,37,48
Lockwood Ave & Grand Ave,21.12638888888889,30.031410256410254,10.602272727272728,26,22,22,26,48
Public Rack - Halsted St & 95th St - SE,4.7978723404255312,4.0523809523809522,4.9283333333333337,7,40,47,0,47
Public Rack - Sawyer Ave & Lawrence Ave,10.493617021276597,9.3677083333333329,11.074731182795698,16,31,47,0,47
Hamlin Ave & 62nd Pl,19.608865248226948,19.874637681159417,7.3833333333333337,46,1,47,0,47
Mozart St & Jackson Blvd,20.107092198581562,19.299333333333337,21.025,25,22,46,1,47
Weekend Night Parking Area D,8.9474637681159415,9.4877192982456151,8.5672839506172842,19,27,46,0,46
Pulaski Rd & 21st St,8.0050724637681157,7.8494791666666668,8.3607142857142858,32,14,46,0,46
Marquette Ave & 89th St,30.675362318840577,33.840909090909093,22.639743589743588,33,13,18,28,46
Kedzie Ave & 73rd St,23.536594202898552,21.196,26.323015873015873,25,21,12,34,46
Public Rack - Laramine Ave & Winnemac Ave,17.206884057971017,12.532051282051281,19.048484848484851,13,33,46,0,46
Springfield Ave & 80th St,33.303260869565214,35.640350877192986,22.202083333333334,38,8,5,41,46
Public Rack - Central Ave & Pensacola Ave,7.6574074074074074,6.6858974358974352,8.0520833333333339,13,32,45,0,45
Cicero Ave & Flournoy St,14.864074074074075,15.40769230769231,14.643229166666668,13,32,24,21,45
Long Ave & Diversey Ave,16.017777777777777,21.1036231884058,10.700757575757574,23,22,27,18,45
Central Park Ave & Douglas Blvd,17.544814814814814,21.836666666666662,8.9611111111111121,30,15,39,6,45
Public Rack - Lawndale Ave & 23rd St,10.214444444444444,10.881531531531531,7.1291666666666664,37,8,45,0,45
Kedzie Ave & Jackson Blvd,21.729629629629628,25.981818181818184,20.353921568627449,11,34,29,16,45
Pittsburgh Ave & Irving Park Rd,46.015925925925927,53.123888888888892,31.8,30,15,29,16,45
Pulaski Rd & 68th St,19.106296296296296,19.398,18.741666666666667,25,20,24,21,45
Public Rack - 111th St - Morgan Park Metra,6.1344696969696972,5.1888888888888882,6.2036585365853663,3,41,44,0,44
Lawndale Ave & 16th St,19.294696969696968,20.130701754385964,14,38,6,44,0,44
Public Rack - Ashland Ave & 91st St,15.033712121212123,10.216666666666667,15.145736434108528,1,43,44,0,44
Cicero Ave & Wellington Ave,20.032945736434115,20.06236559139785,19.956944444444442,31,12,14,29,43
Troy St & Jackson Blvd,14.608139534883719,13.50111111111111,15.201190476190478,15,28,43,0,43
Damen Ave & 51st St,14.026744186046511,16.095555555555553,9.2525641025641026,30,13,14,29,43
Kedzie Ave & 83rd St,19.139922480620157,19.67439024390244,8.1833333333333336,41,2,14,29,43
Public Rack - Jensen Park,8.08449612403101,11.202777777777778,6.8774193548387093,12,31,43,0,43
Commercial Ave & 100th St,22.481395348837211,16.255072463768116,29.641666666666666,23,20,22,21,43
Francisco Ave & 85th St,28.103875968992245,27.827083333333334,31.794444444444441,40,3,11,32,43
Public Rack - Jonathan Y Scammon Public School,13.088888888888887,14.567391304347828,11.299122807017543,23,19,42,0,42
Public Rack - Hiawatha & Mendota,18.545238095238094,22.517460317460323,14.573015873015875,21,21,42,0,42
Public Rack - California Ave & Devon Ave - NW,9.6630952380952362,6.6477777777777778,11.338271604938273,15,27,42,0,42
Ashland Ave & 74th St,45.794444444444444,67.020289855072463,20.1,23,19,10,32,42
Public Rack - Keystone Ave & Irving Park Rd,10.323983739837397,8.6009803921568633,11.544444444444444,17,24,41,0,41
Mason Ave & Grand Ave,20.658943089430888,20.083333333333332,21.027333333333335,16,25,16,25,41
Public Rack - Nashotah & Northwest Hwy,12.2130081300813,10.615079365079366,13.890833333333335,21,20,41,0,41
California Ave & Madison St,35.176016260162605,52.655,18.529365079365075,20,21,14,27,41
Public Rack - Pulaski & Rosemont,14.736991869918702,5.4261904761904756,16.65392156862745,7,34,41,0,41
Tripp Ave & 31st St,29.949583333333337,29.109770114942531,32.163636363636364,29,11,34,6,40
Fullerton & Monitor,22.746249999999996,24.77549019607843,11.247222222222222,34,6,40,0,40
Ashland Ave & 78th St,48.113333333333337,66.520833333333314,20.502083333333328,24,16,16,24,40
Public Rack - Austin Blvd & North Ave,10.750416666666666,9.4993589743589748,13.073809523809524,26,14,40,0,40
Public Rack - Menard Ave & Belmont Ave,21.523333333333333,15.111904761904761,24.975641025641028,14,26,40,0,40
Oketo Ave & Addison St,15.58034188034188,14.591145833333336,20.102380952380951,32,7,36,3,39
Public Rack - Austin Ave & Wrightwood Ave,3.8170940170940173,4.3979166666666663,3.4130434782608696,16,23,39,0,39
Public Rack - Milwaukee Ave & Lawrence Ave,12.262393162393161,12.537179487179486,12.125,13,26,39,0,39
Wellington Ave & Mulligan Ave,14.276923076923078,16.846153846153847,9.138461538461538,26,13,27,12,39
Stony Island Ave & 90th St,22.647008547008546,25.071666666666665,21.810919540229882,10,29,8,31,39
Public Rack - Springfield Ave & Lawrence Ave,13.726495726495726,10.966666666666667,16.348333333333333,19,20,39,0,39
Public Rack - Champlain Ave & 65th St,9.6508547008547,9.3,9.7276041666666675,7,32,39,0,39
Vincennes Ave & 75th St,32.660964912280704,33.639583333333334,27.441666666666666,32,6,4,34,38
Public Rack - Leamington & Elston,19.123684210526314,16.940196078431374,20.891269841269843,17,21,38,0,38
Public Rack - Nagel & Higgins,11.771052631578948,11.464516129032257,13.128571428571428,31,7,38,0,38
Eberhart Ave & 91st St,18.467105263157897,24.004347826086953,9.9766666666666666,23,15,14,24,38
Homewood Ave & 115th St,63.375438596491215,79.9344827586207,10.018518518518517,29,9,7,31,38
Kedzie Ave & 104th St,9.90921052631579,9.90921052631579,,38,0,38,0,38
Public Rack - Central Ave & Lawrence Ave,13.462719298245615,11.579166666666664,14.332051282051282,12,26,38,0,38
Bradley Park,29.503070175438591,30.876515151515154,27.614583333333332,22,16,14,24,38
Troy Ave & 27th St,8.1438596491228079,7.437356321839081,10.420370370370369,29,9,38,0,38
Halsted St & 104th St,41.480630630630621,42.665079365079372,39.92604166666667,21,16,17,20,37
Menard Ave & North Ave,20.181081081081082,15.687499999999996,34.161111111111119,28,9,37,0,37
Public Rack - Kimball Ave & Lawrence Ave,8.4564814814814824,9.8166666666666664,7.484920634920635,15,21,36,0,36
Narragansett & McLean,13.88425925925926,14.913194444444445,11.826388888888888,24,12,36,0,36
Elizabeth St & 92nd St,23.815740740740743,23.874358974358969,23.663333333333334,26,10,13,23,36
Spaulding Ave & 16th St,32.875925925925927,41.952083333333334,14.723611111111113,24,12,28,8,36
Public Rack - Jeffery Blvd & 67th St,19.218055555555555,10.812698412698412,30.985555555555553,21,15,36,0,36
Elizabeth St & 59th St,15.205092592592592,16.825000000000003,14.582051282051284,10,26,34,2,36
Public Rack - Laramie Ave & Grand Ave,15.774999999999999,11.070833333333333,18.127083333333335,12,24,36,0,36
La Villita Park,21.034285714285712,21.414743589743587,19.935185185185183,26,9,16,19,35
Weekend Night Parking Area C,10.255714285714285,10.315476190476188,10.215873015873017,14,21,35,0,35
Kildare & Cermak,10.761904761904761,8.1631313131313128,53.641666666666666,33,2,35,0,35
Public Rack - Kedzie Ave & 60th St,7.68952380952381,3.9083333333333332,7.9186868686868683,2,33,35,0,35
Lavergne Ave & 46th St,14.994761904761905,15.402222222222225,12.55,30,5,35,0,35
Pulaski Rd & 84th St,37.77809523809524,38.320588235294132,19.333333333333332,34,1,5,30,35
Knox Ave & Marquette Ave,22.824019607843137,23.767708333333328,7.725,32,2,17,17,34
Public Rack - Martin Luther King Dr & 44th St,14.742647058823531,14.416666666666666,15.06862745098039,17,17,34,0,34
Public Rack - Lockwood & Archer,9.9102941176470587,9.19469696969697,11.222222222222223,22,12,34,0,34
Racine Ave & 61st St,18.689215686274508,18.898850574712643,17.473333333333333,29,5,7,27,34
Columbus Ave & 79th St,20.000980392156862,18.388095238095236,27.527777777777779,28,6,23,11,34
Parkside Ave & Armitage Ave,22.456862745098039,22.445512820512818,22.49375,26,8,15,19,34
Komensky Ave & 47th St,11.514215686274509,16.699074074074073,5.68125,18,16,18,16,34
Halsted St & 59th St,35.539705882352941,45.421052631578952,23.02333333333333,19,15,15,19,34
Public Rack - N. Oakview and W. Gregory St,12.952450980392154,13.648039215686275,12.25686274509804,17,17,34,0,34
Public Rack - California Ave & Touhy Ave - NW,11.216161616161616,8.93,12.210144927536231,10,23,33,0,33
Pine Ave & Division St,27.686363636363637,29.20961538461539,22.028571428571428,26,7,14,19,33
Public Rack - Kilpatrick & Elston,16.057575757575759,11.897916666666667,17.388666666666666,8,25,33,0,33
Public Rack - Cicero Ave & Belle Plaine Ave,10.303535353535352,5.4363636363636365,12.737121212121213,11,22,33,0,33
Torrence Ave & 106th St,38.083333333333336,43.365079365079367,28.840277777777775,21,12,14,19,33
Kedzie Ave & Archer Ave,19.7578125,22.347222222222221,16.428571428571431,18,14,12,20,32
Public Rack - Fullerton Ave & Narragansett Ave,20.1859375,13.277272727272727,23.804761904761904,11,21,32,0,32
Phillips Ave & 83rd St,28.236979166666668,41.54375,14.930208333333333,16,16,7,25,32
Archer Ave & 43rd St,17.757812500000004,7.2197916666666666,28.295833333333334,16,16,32,0,32
Mayfield Ave & Roosevelt Rd,30.488541666666666,33.461666666666659,25.533333333333328,20,12,22,10,32
Public Rack - Cicero Ave & Wrightwood Ave,12.653645833333334,15.065151515151516,11.390476190476193,11,21,32,0,32
Nordica & Medill,14.388020833333334,15.536363636363639,11.861666666666668,22,10,32,0,32
Public Rack - Kimball Ave & Carmen Ave,13.017708333333335,15.749999999999998,11.775757575757577,10,22,32,0,32
Public Rack - Menard Ave & Dakin St - midblock,12.466145833333334,12.897999999999998,10.923809523809524,25,7,32,0,32
Bennett Ave & 79th St,34.378494623655918,26.185,49.275757575757581,20,11,3,28,31
Public Rack - Sawyer Ave & Bryn Mawr Ave - SE,9.1311827956989227,8.5801282051282044,11.996666666666666,26,5,31,0,31
Rainbow Beach,29.979569892473119,34.2125,22.283333333333335,20,11,1,30,31
State St & 45th St,24.586559139784946,26.836904761904762,22.733333333333334,14,17,7,24,31
Leamington Ave & Hirsch St,32.389444444444443,35.787681159420295,21.223809523809521,23,7,21,9,30
California Ave & 29th St,11.197222222222225,10.703508771929824,12.05,19,11,30,0,30
Harding Ave & Chicago Ave,13.416666666666666,13.473684210526317,13.318181818181817,19,11,10,20,30
Augusta Blvd & Laramie Ave,8.4727777777777771,7.784523809523809,18.108333333333334,28,2,30,0,30
Pulaski Rd & 54th St,9.45,11.978125,6.338461538461539,16,13,24,5,29
Public Rack - Forest Glen Station ,20.621264367816092,21.074509803921568,19.979166666666664,17,12,29,0,29
Sacramento Ave & Pershing Rd,15.646551724137931,16.140151515151516,14.095238095238095,22,7,29,0,29
Major Ave & Bloomingdale Ave,8.20919540229885,6.7724358974358978,20.661111111111108,26,3,29,0,29
Public Rack - Kostner & Peterson,17.691954022988508,11.941666666666666,18.117901234567903,2,27,29,0,29
Archer Ave & Homan Ave,12.740476190476189,19.106666666666666,5.3948717948717952,15,13,12,16,28
Maryland Ave & 104th St,8.0446428571428577,6.8626666666666667,17.894444444444446,25,3,28,0,28
Kilbourn & Roscoe,20.205357142857135,24.893939393939391,17.171568627450981,11,17,28,0,28
Public Rack - Norwood Park Station ,9.4946428571428569,7.41875,10.325,8,20,28,0,28
Public Rack - Keating & Peterson,23.419642857142865,15.579166666666667,24.726388888888891,4,24,28,0,28
Public Rack - Pulaski Rd & Fullerton Ave,9.78095238095238,7.9458333333333337,11.157291666666667,12,16,28,0,28
Public Rack - Nordica & Archer,17.555357142857144,17.360833333333336,18.041666666666668,20,8,28,0,28
Laramie Ave & Gladys Ave,24.046428571428567,26.860784313725492,19.696969696969695,17,11,9,19,28
Monitor Ave & Division St,19.8641975308642,18.243939393939396,20.978125,11,16,13,14,27
Public Rack - Langley Ave & Oakwood Blvd,11.325308641975308,10.861764705882353,12.113333333333333,17,10,27,0,27
Public Rack - Central & Leland,13.413580246913579,15.466666666666667,12.205882352941178,10,17,27,0,27
Avenue L & 114th St,10.108024691358024,8.8789855072463766,17.175,23,4,27,0,27
Bloomingdale Ave & Harlem Ave,20.556790123456789,18.679166666666667,25.921428571428571,20,7,27,0,27
Homan Ave & 65th St,12.270987654320987,12.270987654320987,,27,0,27,0,27
Public Rack - Imlay & Milwaukee,22.113580246913578,23.486805555555556,11.127777777777776,24,3,27,0,27
Public Rack - Western Ave & 110th St,11.392948717948718,19.373333333333335,9.492857142857142,5,21,26,0,26
Public Rack - 4810 Keeler Ave,12.498717948717948,10.795238095238094,13.126315789473685,7,19,26,0,26
South Chicago Ave & 83rd St,22.666666666666668,23.78717948717949,21.54615384615385,13,13,9,17,26
Public Rack - Karlov Ave & Milwaukee Ave,10.760897435897437,6.6744444444444442,16.333333333333332,15,11,26,0,26
Public Rack - Western & 83rd,23.346153846153843,8.7222222222222214,25.253623188405797,3,23,26,0,26
Public Rack - Parkside & Archer,8.3044871794871788,7.93095238095238,8.7402777777777771,14,12,26,0,26
Public Rack - Bishop St & 46th St,18.61474358974359,31.611111111111107,16.919565217391309,3,23,26,0,26
Public Rack - Melvina & Foster,13.798666666666666,18.057142857142857,8.3787878787878789,14,11,25,0,25
Public Rack - Komensky Ave & 59th St,5.2186666666666666,5.4462962962962962,5.0906250000000011,9,16,25,0,25
Sacramento Blvd & Polk St,14.786666666666667,15.520833333333334,13.481481481481483,16,9,25,0,25
Racine Ave & 57th St,14.9,16.82549019607843,10.808333333333334,17,8,17,8,25
Rhodes Ave & 71st St,17.88133333333333,18.102777777777774,17.676923076923078,12,13,17,8,25
Major Taylor Trail & 124th St,59.939333333333337,64.099206349206327,38.1,21,4,3,22,25
Public Rack - Lotus Ave & Lawrence Ave,8.9125,4.1428571428571432,10.876470588235295,7,17,24,0,24
Public Rack - Prairie Ave & Garfield Blvd N,9.1076388888888875,10.75,7.166666666666667,13,11,24,0,24
Public Rack - Avondale Ave & Addison St,8.3645833333333339,7.8513888888888888,8.8777777777777764,12,12,24,0,24
Public Rack - Milwaukee Ave & Leland Ave,12.295138888888889,11.666666666666666,12.672222222222222,9,15,24,0,24
Mango Ave & North Ave,31.386111111111109,31.74848484848485,27.4,22,2,14,10,24
Panama Ave & Grace St,17.5036231884058,19.4,4.8611111111111116,20,3,23,0,23
Lavergne & Fullerton,16.492028985507243,15.298333333333334,17.410256410256409,10,13,23,0,23
Public Rack - Milwaukee Ave & Pensacola Ave,3.6282608695652177,4.29537037037037,1.2266666666666666,18,5,23,0,23
Orange Ave & Addison St,13.839130434782609,15.101041666666664,10.954761904761906,16,7,10,13,23
Public Rack - Spaulding Ave & Bryn Mawr Ave,7.8630434782608685,7.53,8.11923076923077,10,13,23,0,23
Carpenter St & 63rd St,27.545652173913041,26.246078431372553,31.227777777777778,17,6,12,11,23
Homan Ave & Fillmore St,11.248550724637681,9.7966666666666651,13.970833333333333,15,8,23,0,23
Public Rack - Cicero Ave & Roscoe St,10.283333333333335,8.89375,11.024444444444445,8,15,23,0,23
Public Rack - Christiana & Lincoln,12.480434782608695,13.254166666666666,12.067777777777776,8,15,23,0,23
Public Rack - Milwaukee Ave & Addison St,15.315217391304348,12.8,18.584999999999997,13,10,23,0,23
Kildare Ave & 85th St,27.089130434782604,26.206060606060603,46.516666666666666,22,1,0,23,23
Public Rack - 63rd Pl & Narraganssett Ave,12.486956521739129,12.486956521739129,,23,0,23,0,23
Public Rack - Throop St & 109th Pl,10.105072463768115,39.016666666666666,5.7683333333333335,3,20,23,0,23
Public Rack - Kenneth & Carmen,16.083333333333332,19.833333333333332,9.0520833333333339,15,8,23,0,23
Yates Blvd & 93rd St,25.695652173913047,28.869607843137256,16.702777777777776,17,6,3,20,23
Keeler Ave & Roosevelt Rd,17.371014492753623,18.557843137254903,14.008333333333333,17,6,23,0,23
Lowell Ave & Armitage Ave,20.670289855072461,24.483333333333334,18.636666666666667,8,15,15,8,23
W 103rd St & S Avers Ave,10.927536231884057,11.327777777777776,6.725,21,2,23,0,23
Throop St & 52nd St,35.967424242424244,47.053846153846152,19.953703703703702,13,9,3,19,22
Public Rack - Mango & Higgins,10.180303030303032,5.7833333333333332,10.874561403508773,3,19,22,0,22
Paulina Ave & 87th St,29.63787878787879,24.872549019607842,45.84,17,5,7,15,22
Narragansett Ave & Montrose Ave,19.97878787878788,18.037777777777777,24.138095238095236,15,7,10,12,22
Public Rack - King Dr & 115th St,10.040909090909091,12.835897435897436,6.0037037037037031,13,9,22,0,22
Public Rack - Sacramento Ave & Devon Ave,16.672727272727272,22.338888888888892,9.8733333333333331,12,10,22,0,22
Public Rack - Kostner & Bryn Mawr,16.131060606060608,18.02121212121212,14.24090909090909,11,11,22,0,22
Public Rack - Kimball & Ardmore,12.891666666666667,12.933333333333334,12.879411764705882,5,17,22,0,22
Public Rack - Langley Ave & 105th Pl,8.97777777777778,9.6166666666666671,2.9083333333333332,19,2,21,0,21
Kedzie Ave & 54th Pl,8.795238095238096,5.6884615384615378,13.84375,13,8,12,9,21
Columbus Ave & 83rd Pl,12.100793650793651,10.791666666666666,14.719047619047618,14,7,13,8,21
Public Rack - Western Ave & 100th St,7.6706349206349209,5.4354166666666668,9.046153846153846,8,13,21,0,21
Spaulding Ave & 63rd,30.836507936507939,37.589285714285715,17.330952380952379,14,7,2,19,21
Public Rack - Lynch & Elston,11.618253968253969,4.0516666666666667,18.496969696969696,10,11,21,0,21
Mulligan Ave & Wellington Ave,9.65952380952381,8.26060606060606,11.198333333333332,11,10,21,0,21
Public Rack - Kedzie Ave & Archer Ave,7.1238095238095243,5.5072916666666663,12.296666666666665,16,5,21,0,21
Long Ave & North Ave,17.477777777777778,20.957777777777778,8.7777777777777768,15,6,18,3,21
Public Rack - Kedzie Ave & Chicago Ave,12.224603174603175,13.1,11.95104166666667,5,16,21,0,21
Kenosha & Wellington,13.617460317460317,11.825,13.806140350877191,2,19,21,0,21
Public Rack - Normal Ave & 111th St,10.303968253968254,16.039743589743587,0.98333333333333328,13,8,21,0,21
Michigan Ave & 114th St,18.05873015873016,20.881111111111114,11.002777777777776,15,6,10,11,21
Tripp Ave & 15th St,50.204761904761909,54.960416666666667,47.27820512820513,8,13,18,3,21
Public Rack - Leader & Caldwell,24.027499999999996,39.80833333333333,8.2466666666666661,10,10,20,0,20
Public Rack - Laramie Ave & Belmont Ave,14.8775,12.6375,16.370833333333334,8,12,20,0,20
Grace & Cicero,14.0175,8.0925925925925917,18.865151515151517,9,11,14,6,20
Public Rack - Bryn Mawr Ave & Spaulding Ave,14.808333333333334,17.384722222222226,10.94375,12,8,20,0,20
Public Rack - Wolcott Ave & 61st St,13.339999999999998,16.288095238095242,11.752564102564103,7,13,20,0,20
Olive Harvey College,29.754166666666674,32.79270833333333,17.6,16,4,11,9,20
Rockwell St & 63rd St,31.100833333333334,13.886458333333335,99.958333333333329,16,4,20,0,20
Public Rack - Kenton Ave & Palmer St,15.751666666666667,14.372619047619049,18.969444444444445,14,6,20,0,20
Ewing Ave & 106th St,24.578333333333333,24.507407407407406,25.216666666666665,18,2,12,8,20
Altgeld Gardens,85.185,89.5,3.2,19,1,8,12,20
Public Rack - Western Ave & 92nd Pl,8.2973684210526315,7.5597222222222218,9.5619047619047617,12,7,19,0,19
Kilbourn Ave & 49th St,11.210526315789474,14.91111111111111,4.8666666666666663,12,7,3,16,19
Central Park Ave & 66th St,24.869298245614036,23.595370370370372,47.8,18,1,11,8,19
Public Rack - 56th St & Mulligan Ave,8.8692982456140346,9.553125,5.2222222222222223,16,3,19,0,19
Wood St & 84th St,39.21052631578948,30.163095238095242,64.543333333333337,14,5,4,15,19
Lockwood Ave and Grand Ave,16.296491228070174,19.072727272727271,12.479166666666666,11,8,9,10,19
Mulligan Ave & Archer Ave,16.390350877192986,23.672222222222224,13.029487179487178,6,13,6,13,19
Public Rack - Kostner Ave & Wrightwood Ave,6.1833333333333336,7.291666666666667,5.377272727272727,8,11,19,0,19
Public Rack - Lockwood Ave & Diversey Ave,8.3491228070175438,7.5875,8.9030303030303024,8,11,19,0,19
Burley Ave & 85th St,38.796491228070174,48.24666666666667,3.3583333333333334,15,4,4,15,19
Public Rack - Mobile Ave & Archer Ave,11.209259259259261,9.0916666666666668,15.444444444444445,12,6,18,0,18
Public Rack - Newcastle & Archer,7.7305555555555552,8.0627450980392155,2.0833333333333335,17,1,18,0,18
Rockwell St & Archer Ave,9.1333333333333329,6.6777777777777789,21.411111111111111,15,3,18,0,18
Lavergne Ave & Diversey Ave,16.55925925925926,20.669444444444441,14.504166666666666,6,12,10,8,18
S Aberdeen St & W 106th St,16.406481481481482,43.596666666666664,5.94871794871795,5,13,18,0,18
Public Rack - Houston Ave & 131st St,19.595370370370365,19.595370370370365,,18,0,18,0,18
Kildare Ave & Archer Ave,16.37962962962963,18.245833333333334,15.846428571428572,4,14,6,12,18
Mozart St & 55th St,23.116666666666667,35.414583333333333,12.185185185185185,8,9,9,8,17
Public Rack - St Louis & Lincoln,9.9372549019607845,8.4227272727272737,12.713888888888887,11,6,17,0,17
Public Rack - Evans Ave & 63rd St,19.505882352941175,15.745833333333334,20.66282051282051,4,13,17,0,17
Public Rack - Hamilton Ave & 95th St,10.495098039215687,11.594444444444443,7.8566666666666665,12,5,17,0,17
S Wentworth Ave & W 111th St,13.011764705882351,14.921794871794871,6.8041666666666663,13,4,17,0,17
Public Rack - Halsted St & 111th St,7.545098039215687,6.9476190476190469,7.9633333333333338,7,10,17,0,17
Ada St & 113th St,33.912745098039217,35.259722222222223,30.68,12,5,5,12,17
Public Rack - Lavergne Ave & Belle Plaine Ave,10.513725490196077,13.013333333333332,6.9428571428571422,10,7,17,0,17
Public Rack - Greenwood Ave & Lake Park Ave,12.110784313725491,12.259523809523811,12.006666666666666,7,10,17,0,17
Public Rack - Cicero Ave & Cortland St - midblock,8.5490196078431389,9.9277777777777771,6.9979166666666668,9,8,17,0,17
Public Rack - Karlov Ave & Kamerling Ave,16.733333333333334,19.489583333333332,14.283333333333333,8,9,17,0,17
Woodlawn & 103rd,6.2480392156862736,6.2480392156862736,,17,0,17,0,17
Public Rack - Overhill Ave & Touhy Ave,31.243137254901963,28.847435897435897,39.029166666666669,13,4,17,0,17
Public Rack - Avenue M & 132nd St,23.176470588235293,23.010416666666668,25.833333333333332,16,1,17,0,17
Public Rack - Woodlawn Ave & 63rd St S,8.0885416666666661,11.826190476190476,5.181481481481482,7,9,16,0,16
Public Rack - Karlov Ave & Lawrence Ave,13.521875,6.2648148148148142,22.852380952380951,9,7,16,0,16
Public Rack - St Louis Ave & Berteau Ave,10.0125,8.6,12.366666666666667,10,6,16,0,16
Public Rack - Minuteman Park,10.263541666666667,10.263541666666667,,16,0,16,0,16
Public Rack - Kildare Ave & North Ave,15.94375,15.5,16.091666666666669,4,12,16,0,16
Public Rack - Brandon Ave & 91st St,10.933333333333334,12.3,10.842222222222222,1,15,16,0,16
Public Rack - State ST & 42nd St,15.252083333333333,19.379166666666666,11.125,8,8,16,0,16
Western Ave & 81st St,52.806249999999991,64.0871794871795,3.9222222222222225,13,3,3,13,16
Public Rack - Neva Ave & Grand Ave,30.309375,6.9125,38.108333333333327,4,12,16,0,16
Public Rack - Peterson Ave & Milwaukee Ave,56.736458333333339,3.4878787878787878,173.8833333333333,11,5,16,0,16
Wabash Ave & 49th St,27.635416666666671,30.030000000000005,23.644444444444446,10,6,4,12,16
Public Rack - Western Ave & Jarvis Ave,9.4244444444444451,4.1,12.086666666666668,5,10,15,0,15
Public Rack - Prairie Ave & 47th St ,9.3122222222222231,5.5266666666666673,11.205,5,10,15,0,15
Public Rack - Langley Ave & 79th St,15.33111111111111,16.827777777777776,14.333333333333334,6,9,15,0,15
Public Rack - Hoyne Ave & 110th Pl,7.6066666666666665,11.85,6.0636363636363635,4,11,15,0,15
Public Rack - Talman Ave & Pershing Rd,11.574444444444444,2.3666666666666667,16.178333333333331,5,10,15,0,15
Public Rack - Kenton & Lawrence,14.257777777777779,10.488888888888889,16.770370370370372,6,9,15,0,15
Public Rack - Garfield Park Conservatory,13.621111111111111,11.758333333333333,14.862962962962964,6,9,15,0,15
Public Rack - Menard Ave & Grand Ave,10.75888888888889,11.811666666666666,8.6533333333333342,10,5,15,0,15
Public Rack - Melvina Ave & Montrose Ave,8.3466666666666658,8.01,8.5149999999999988,5,10,15,0,15
Public Rack - King Dr & 71st St,9.0044444444444434,20.646666666666665,3.1833333333333331,5,10,15,0,15
Public Rack - Christiana Ave & Bryn Mawr Ave,16.325555555555557,21.161111111111111,13.101851851851851,6,9,15,0,15
Plainfield & Irving Park,15.396666666666668,19.2,4.9375,11,4,15,0,15
Public Rack - 532 E 43rd St,8.8377777777777773,15.190476190476188,3.2791666666666668,7,8,15,0,15
Public Rack - Delphina & Foster,13.168888888888887,13.390740740740741,12.83611111111111,9,6,15,0,15
Public Rack - Ewing Ave & 101st St,13.423333333333336,8.90357142857143,76.7,14,1,15,0,15
Public Rack - California Ave & Ogden Ave,20.322222222222219,22.005555555555553,17.797222222222221,9,6,15,0,15
Public Rack - Halsted St & 63rd St,31.740000000000002,19.183333333333334,32.636904761904766,1,14,15,0,15
Public Rack - Elston Ave & Kenneth Ave,27.853571428571435,27.713888888888889,27.958333333333332,6,8,14,0,14
Public Rack - Central Ave & George St,9.6833333333333336,11.025,9.4597222222222221,2,12,14,0,14
Public Rack - Tripp Ave & North Ave,13.236904761904762,15.09047619047619,11.383333333333333,7,7,14,0,14
Kedzie Ave & 60th St,21.358333333333334,22.694871794871794,3.9833333333333334,13,1,0,14,14
La Villita Park (Albany/30th),13.328571428571427,13.328571428571427,,14,0,14,0,14
Public Rack - Cicero Ave & Altgeld St,8.8488095238095248,9.5380952380952362,8.15952380952381,7,7,14,0,14
Mayfield & Roosevelt Rd,15.003571428571428,16.415,11.475,10,4,14,0,14
Commercial Ave & 97th St,13.201190476190474,12.445833333333333,13.503333333333334,4,10,3,11,14
Public Rack - Central Park & Peterson,14.425000000000002,11.508333333333333,15.591666666666667,4,10,14,0,14
Public Rack - Forrestville Ave & 47th St,9.23452380952381,6.125,11.566666666666665,6,8,14,0,14
Western Ave & 62nd St,7.9702380952380958,6.77361111111111,15.15,12,2,14,0,14
Public Rack - Jeffrey Blvd & 71st St,5.1488095238095237,4.7958333333333334,5.29,4,10,14,0,14
Public Rack - Monticello & Lawrence,9.8392857142857135,7.0972222222222223,11.895833333333334,6,8,14,0,14
Public Rack - Laramie Ave & Fullerton Ave,21.141666666666666,5.666666666666667,27.331666666666667,4,10,14,0,14
Menard Ave & Division St,13.262820512820515,10.733333333333331,16.213888888888889,7,6,13,0,13
Public Rack - Cicero & 64th,18.9474358974359,17.102777777777778,41.083333333333336,12,1,13,0,13
Public Rack - Milwaukee Ave & Sunnyside Ave,9.4692307692307676,6.9433333333333334,11.047916666666667,5,8,13,0,13
Public Rack - Cottage Grove & 86th St,4.1371794871794867,1.4333333333333333,4.3625,1,12,13,0,13
Public Rack - Mulligan Ave & 56th St,9.155555555555555,9.5900000000000016,6.9833333333333334,10,2,12,0,12
Public Rack - Natoma Ave & Bryn Mawr Ave,10.933333333333334,13.566666666666666,5.666666666666667,8,4,12,0,12
Public Rack - Irving Park Rd & Parkside Ave,10.184722222222224,14.806666666666667,6.8833333333333337,5,7,12,0,12
Eggleston Ave & 92nd St,16.083333333333332,16.398484848484848,12.616666666666667,11,1,7,5,12
Public Rack - Wentworth Park,14.440277777777776,15.655,8.3666666666666671,10,2,12,0,12
Public Rack - Winona St & Elston Ave,18.040277777777774,19.863333333333333,16.738095238095237,5,7,12,0,12
Public Rack - Central Park & Bryn Mawr,10.247222222222224,9.9583333333333339,10.53611111111111,6,6,12,0,12
Public Rack - Lawrence Ave & Kimball Ave,12.37638888888889,8.3458333333333332,14.391666666666667,4,8,12,0,12
Public Rack - Peterson Park,21.145833333333332,17.661904761904761,26.023333333333333,7,5,12,0,12
Public Rack - Halsted St & 95th St - SW,5.1736111111111116,,5.1736111111111116,0,12,12,0,12
Wentworth Ave & 104th St,45.026388888888881,45.026388888888881,,12,0,3,9,12
Public Rack - Canfield & Victoria,19.4625,20.527083333333334,17.333333333333332,8,4,12,0,12
Public Rack - South Shore Dr & 71st St,19.868055555555557,23.5375,12.529166666666667,8,4,12,0,12
Public Rack - Kildare Ave & Washignton Blvd,13.22361111111111,14.290740740740743,10.02222222222222,9,3,12,0,12
Public Rack - Keystone Ave & North Ave,15.354166666666666,17.407407407407408,9.1944444444444446,9,3,12,0,12
Public Rack - Melvina Ave & Belmont Ave,13.125757575757577,12.457142857142857,14.295833333333333,7,4,11,0,11
Public Rack - Wood St & 103rd St,6.8015151515151517,7.0547619047619046,6.3583333333333334,7,4,11,0,11
Homan Ave & 26th St,23.395454545454545,26.15625,16.033333333333335,8,3,7,4,11
Public Rack - Ozark Ave & Addison St,5.7151515151515158,5.6907407407407407,5.825,9,2,11,0,11
Public Rack - Marquette Ave & 83rd St,11.057575757575759,18.472222222222221,8.2770833333333336,3,8,11,0,11
Public Rack - Eli Whitney Public School,7.1151515151515152,11.976666666666667,3.0638888888888887,5,6,11,0,11
Public Rack - Western Ave & 111th St - SW,10.234848484848486,6.2055555555555548,15.069999999999999,6,5,11,0,11
Public Rack - Linder Ave & Archer Ave,6.2212121212121207,6.3066666666666666,6.15,5,6,11,0,11
Public Rack - Pulaski Rd & Stevens Ave,8.9863636363636363,14.544444444444444,6.9020833333333336,3,8,11,0,11
Public Rack - Sayre Ave & 59th St,17.55,17.55,,11,0,11,0,11
Public Rack - Avers & Granville,9.384848484848483,6.083333333333333,10.622916666666667,3,8,11,0,11
Public Rack - Halsted St & 76th St,4.2818181818181822,0.71333333333333326,7.2555555555555555,5,6,11,0,11
Public Rack - Bell Ave & 95th St,2.9106060606060615,3.1883333333333335,0.13333333333333333,10,1,11,0,11
Public Rack - Central Park Ave & Fulton Blvd,31.498484848484846,41.635416666666657,4.4666666666666668,8,3,11,0,11
Public Rack - Stewart Ave & 123rd St,16.633333333333333,16.633333333333333,,11,0,11,0,11
Lamon Ave & 47th St,33.416666666666671,39.496296296296286,6.0583333333333336,9,2,5,6,11
Laramie Ave & Bloomingdale Ave,27.854545454545452,35.12083333333333,23.702380952380953,4,7,9,2,11
Public Rack - Irving Park Rd & Menard Ave,7.3149999999999995,8.0416666666666661,4.4083333333333332,8,2,10,0,10
Public Rack - Western Ave & 47th Pl,7.0966666666666658,7.7,7.0296296296296292,1,9,10,0,10
Public Rack - Milwaukee Ave & Warner Ave,17.525,10.625,19.25,2,8,10,0,10
Public Rack - Ewing Ave & 99th St,8.8433333333333337,0.18333333333333332,9.8055555555555536,1,9,10,0,10
Public Rack - Kedzie Ave & 63rd St,9.581666666666667,9.45277777777778,9.775,6,4,10,0,10
Public Rack - Chase Ave & Touhy Ave - NE,3.4250000000000003,2.505555555555556,3.8190476190476188,3,7,10,0,10
Public Rack - Kedvale Ave & Peterson Ave,16.331666666666663,26.972222222222221,11.77142857142857,3,7,10,0,10
Public Rack - Natoma Ave & 61st St,11.356666666666666,11.356666666666666,,10,0,10,0,10
Public Rack - Christiana Ave & Archer Ave,7.1850000000000005,7.0738095238095244,7.4444444444444438,7,3,10,0,10
Public Rack - Christiana Ave & Lawrence Ave,10.018333333333333,8.0633333333333344,11.973333333333333,5,5,10,0,10
Public Rack - Western Ave & 104th St - East,7.6316666666666659,6.2458333333333336,8.5555555555555536,4,6,10,0,10
Public Rack - Northwest Hwy & Bryn Mawr,7.6616666666666662,5.4880952380952381,12.733333333333333,7,3,10,0,10
Public Rack - Hamlin Ave & Grand Ave,9.7,12.47,6.9300000000000006,5,5,10,0,10
Public Rack - Pulaski Rd & Lake St,3.7800000000000002,4.15,3.6875,2,8,10,0,10
Public Rack - Lafayette Ave & 87th St - NW,10.405,,10.405,0,10,10,0,10
Public Rack - Touhy Ave & Oconto Ave,13.651666666666667,12.594444444444441,23.166666666666668,9,1,10,0,10
Public Rack - Wood St & 47th St,15.01,7.6,19.95,4,6,10,0,10
Public Rack - Kedzie Ave & 58th St,10.548333333333334,4.4933333333333341,16.603333333333335,5,5,10,0,10
Public Rack - Oketo Ave & Belmont Ave,10.860000000000001,3.43,18.290000000000003,5,5,10,0,10
Public Rack - Lowe Park,18.941666666666666,0.033333333333333333,21.042592592592595,1,9,10,0,10
Public Rack - Parkside & 63rd,9.1783333333333346,8.0370370370370363,19.45,9,1,10,0,10
Archer Ave & 49th St,15.318333333333332,20.933333333333334,2.2166666666666668,7,3,6,4,10
Racine Ave & 65th St,43.125,57.69444444444445,21.270833333333332,6,4,4,6,10
Kildare Ave & 85th St (Kostner Ave & 87th St TEMPORARY),54.541666666666664,54.541666666666664,,10,0,0,10,10
Public Rack - Western Ave & 106th St - East,6.3537037037037036,6.947916666666667,1.6,8,1,9,0,9
Public Rack - Maplewood Ave & 47th St,5.5666666666666664,8.725,4.6642857142857137,2,7,9,0,9
Public Rack - Division St & Christiana Ave,9.7814814814814817,,9.7814814814814817,0,9,9,0,9
Public Rack - Lamon Ave & Archer Ave,8.9629629629629619,3.6416666666666666,10.483333333333333,2,7,9,0,9
Public Rack - Cicero Ave & North Ave,7.4870370370370365,9.86111111111111,6.3,3,6,9,0,9
Public Rack - Kedzie Ave & Walnut St,14.916666666666668,14.275,15.43,4,5,9,0,9
Public Rack - Neenah & Archer,11.82037037037037,13.139583333333333,1.2666666666666666,8,1,9,0,9
Public Rack - Narragansett Ave & Fullerton Ave,7.6333333333333337,8.3027777777777771,6.2944444444444434,6,3,9,0,9
Public Rack - Lemont Ave & Keating Ave,17.661111111111111,7.975,20.428571428571431,2,7,9,0,9
Public Rack - Mont Clare Ave & Higgins Ave,17.003703703703703,16.416666666666668,17.7375,5,4,9,0,9
Public Rack - Peterson Ave & Drake Ave,13.407407407407408,21.233333333333334,12.429166666666667,1,8,9,0,9
Public Rack - Irving Park Rd & Austin Ave,8.3833333333333329,9.1133333333333333,7.4708333333333332,5,4,9,0,9
Public Rack - Austin & Higgins,19.207407407407409,12.55,22.536111111111111,3,6,9,0,9
Public Rack - Michigan Ave & 107th St,11.227777777777778,12.577777777777778,10.552777777777777,3,6,9,0,9
Public Rack - Normandy Ave & Archer Ave,8.1444444444444439,5.1583333333333323,14.116666666666667,6,3,9,0,9
Indiana Ave & 133rd St,32.925925925925917,36.439583333333324,4.8166666666666664,8,1,9,0,9
S Michigan Ave & E 118th St,6.5592592592592593,7.0357142857142865,4.8916666666666666,7,2,9,0,9
Public Rack - Central & Prescott,29.407407407407408,32.587500000000006,3.9666666666666668,8,1,9,0,9
Homan Ave & 77th St,54.155555555555551,54.155555555555551,,9,0,0,9,9
Public Rack - Hamlin Ave & Madison St,19.464583333333334,19.488888888888891,19.45,3,5,8,0,8
Public Rack - Chopin Park,4.4020833333333336,4.3472222222222223,4.5666666666666664,6,2,8,0,8
Public Rack - Racine Ave & 74th St,9.23125,4.583333333333333,9.8952380952380938,1,7,8,0,8
Public Rack - Spaulding Ave & Foster Ave,7.65625,0.1,8.7357142857142858,1,7,8,0,8
Public Rack - Mackinaw Ave & 85th St,14.952083333333333,14.952083333333333,,8,0,8,0,8
Public Rack - Whipple St & 63rd St,9.85,7.3555555555555552,11.346666666666666,3,5,8,0,8
Michigan Ave & 105th St,15.356249999999998,15.356249999999998,,8,0,6,2,8
Public Rack - Central & Berteau,11.295833333333333,6.8583333333333334,15.733333333333333,4,4,8,0,8
Kedzie Ave & 38th St,49.352083333333333,64.336111111111123,4.4,6,2,3,5,8
Wabash Ave & 59th St,12.641666666666667,8.51388888888889,25.025,6,2,1,7,8
State St & 123rd St,27.645833333333332,27.645833333333332,,8,0,6,2,8
Public Rack - Sawyer Ave & Chicago Ave,8.6,17.816666666666666,7.2833333333333323,1,7,8,0,8
Public Rack - Foster Ave & Drake Ave,20.747916666666665,27.98,8.6944444444444446,5,3,8,0,8
Public Rack - N Narragansett Ave & Grand Ave,13.722916666666666,10.854166666666666,16.591666666666665,4,4,8,0,8
Public Rack - Bryn Mawr Ave & Milwaukee Ave,8.8708333333333336,4.9733333333333327,15.366666666666667,5,3,8,0,8
Public Rack - Halsted St & 80th St,0.73125,0.64285714285714279,1.35,7,1,8,0,8
Glenlake Ave & Pulaski Rd,79.902083333333337,262.84166666666664,18.922222222222224,2,6,0,8,8
Public Rack - Ewing Ave & 107th St,17.34375,17.34375,,8,0,8,0,8
Public Rack - Pulaski Rd & 65th St,11.868749999999999,,11.868749999999999,0,8,8,0,8
Public Rack - Bernard St & Foster Ave,5.0928571428571425,7.2055555555555548,3.5083333333333333,3,4,7,0,7
Public Rack - Talman Ave & 51st St,8.9904761904761887,3.0333333333333332,11.373333333333335,2,5,7,0,7
Eberhart Ave & 131st St,25.740476190476191,28.644444444444446,8.3166666666666664,6,1,5,2,7
Public Rack - Laflin St &51st ST,12.511904761904761,16.366666666666667,10.97,2,5,7,0,7
Public Rack - Kedzie Ave & 54th St - SW,2.4690476190476196,1.8416666666666666,6.2333333333333334,6,1,7,0,7
Public Rack - Kostner Ave & North Ave,9.1285714285714281,,9.1285714285714281,0,7,7,0,7
Public Rack - Sawyer Ave & Bryn Mawr Ave - SW,10.466666666666667,14.466666666666667,7.4666666666666668,3,4,7,0,7
Public Rack - California Ave & Touhy Ave - SW,7.6047619047619044,7.4333333333333336,7.6333333333333337,1,6,7,0,7
Public Rack - Kedzie Ave & 54th St - SE,12.661904761904761,13.01,11.791666666666666,5,2,7,0,7
Public Rack - S Menard & W 63rd,7.1547619047619042,5.375,17.833333333333332,6,1,7,0,7
Public Rack - S. Kilpatrick and W. 79th,11.847619047619048,13.130555555555556,4.15,6,1,7,0,7
Public Rack - Harding Ave & 47th St,23.007142857142856,23.858333333333334,21.87222222222222,4,3,7,0,7
Public Rack - California Ave & Pershing Rd,8.5166666666666675,0.25,9.8944444444444439,1,6,7,0,7
Public Rack - Francisco Ave & Touhy Ave,3.8785714285714277,0.4,4.458333333333333,1,6,7,0,7
Public Rack - Neva & Foster,12.052380952380952,15.166666666666666,10.806666666666667,2,5,7,0,7
Public Rack - Eberhart Ave & 61st St,14.47857142857143,10.333333333333334,20.005555555555556,4,3,7,0,7
Public Rack - Kedzie & 103rd St - W,1.373809523809524,1.373809523809524,,7,0,7,0,7
Public Rack - Milwaukee Ave & Waveland Ave,12.545238095238094,0.016666666666666666,14.633333333333333,1,6,7,0,7
Public Rack - Avenue J & 112th St,30.997619047619043,30.997619047619043,,7,0,7,0,7
Public Rack - King Dr & Oakwood Blvd,20.207142857142856,33.30416666666666,2.7444444444444445,4,3,7,0,7
Public Rack - Sayer & Northwest Hwy,10.190476190476192,14.35,7.0708333333333337,3,4,7,0,7
Public Rack - Pratt Ave & Odell Ave,36.121428571428559,47.766666666666659,7.0083333333333337,5,2,7,0,7
Public Rack - Laflin St & 51st St,9.4690476190476183,8.155555555555555,10.454166666666667,3,4,7,0,7
Public Rack - Homan Ave & 62nd Pl,12.354761904761904,12.354761904761904,,7,0,7,0,7
Public Rack - Avenue J & 106th St,21.292857142857144,17.716666666666665,30.233333333333334,5,2,7,0,7
Public Rack - Michigan Ave & 96th St,12.780952380952382,11.486666666666668,16.016666666666666,5,2,7,0,7
Public Rack - Lawndale Ave & Polk St,6.0472222222222216,,6.0472222222222216,0,6,6,0,6
Public Rack - Austin Ave & Wellington Ave,6.2138888888888886,9.7666666666666675,5.503333333333333,1,5,6,0,6
Public Rack - Pulaski Rd & 51st Rd,9.0388888888888879,10.825,8.1458333333333339,2,4,6,0,6
Public Rack - Central Park Ave & Fillmore St,6.5527777777777771,10.216666666666667,4.7208333333333332,2,4,6,0,6
Public Rack - Michele Clark Magnet High School,12.213888888888887,13.922222222222221,10.505555555555555,3,3,6,0,6
Public Rack - Linder Ave & Belmont Ave,8.5777777777777775,11.104166666666666,3.525,4,2,6,0,6
Public Rack - Austin Ave & Roscoe St,9.8444444444444432,21.766666666666666,3.8833333333333333,2,4,6,0,6
Public Rack - Damen Ave & 47th St,8.7777777777777768,7.6166666666666663,9.01,1,5,6,0,6
Public Rack - Robert Fulton Elementary School,9.5694444444444464,13.2625,2.1833333333333331,4,2,6,0,6
Public Rack - Cicero Ave & Wellington Ave,7.7138888888888886,5.416666666666667,12.308333333333334,4,2,6,0,6
Public Rack - Meade Ave & Archer Ave,9.1583333333333332,11.5875,4.3,4,2,6,0,6
Public Rack - Nina Ave & Avondale Ave,10.986111111111111,,10.986111111111111,0,6,6,0,6
Public Rack - Kimbark Ave & 67th St,16.919444444444444,16.919444444444444,,6,0,6,0,6
Public Rack - Hiawatha Ave & Minnehaha Ave,17.694444444444443,24.466666666666665,14.308333333333334,2,4,6,0,6
Public Rack - Parkside & Elston,9.325,11.977777777777778,6.6722222222222225,3,3,6,0,6
Public Rack - Laramie Ave & Warwick Ave,13.4,17.8875,4.425,4,2,6,0,6
Public Rack - Clyde Ave & 87th St,10.941666666666666,10.941666666666666,,6,0,6,0,6
Public Rack - Kedvale Ave & 63rd St E,13.608333333333336,,13.608333333333336,0,6,6,0,6
Public Rack - Homan Ave & 26th St,9.06388888888889,9.3777777777777764,8.75,3,3,6,0,6
Public Rack - Norwood Park,9.4833333333333325,9.07,11.55,5,1,6,0,6
Public Rack - Fullerton Ave & Lavergne Ave,10.202777777777778,15.925,7.3416666666666668,2,4,6,0,6
Public Rack - Richmond St & Thorndale Ave,12.788888888888888,23.683333333333334,1.8944444444444444,3,3,6,0,6
Public Rack - Jeffery Blvd & 83rd St,8.2138888888888886,17.266666666666666,6.4033333333333342,1,5,6,0,6
Public Rack - Irving Park Rd & Melvina Ave,15.683333333333334,18.513333333333332,1.5333333333333334,5,1,6,0,6
Public Rack - Emerald Ave & 43rd St,19.016666666666666,14.416666666666666,21.316666666666666,2,4,6,0,6
Public Rack - Avers Ave & Ogden Ave,20.6,12.933333333333334,24.433333333333334,2,4,6,0,6
Public Rack - Buffalo Ave & 89th St,8.6916666666666664,15.983333333333333,7.2333333333333334,1,5,6,0,6
Kildare & Chicago Ave,11.461111111111112,3.575,27.233333333333334,4,2,6,0,6
Public Rack - Morgan St & 95th St,4.791666666666667,,4.791666666666667,0,6,6,0,6
Public Rack - Mozart Elementary School,19.222222222222221,19.216666666666665,19.227777777777774,3,3,6,0,6
Public Rack - Kedzie Ave & 61st Pl W,16.961111111111112,10.238888888888887,23.683333333333334,3,3,6,0,6
Lexington & California Ave,17.816666666666666,17.286666666666669,20.466666666666665,5,1,4,2,6
Public Rack - State St & 47th st,9.05,7.1166666666666663,9.5333333333333332,1,4,5,0,5
Public Rack - Kedzie Ave & Pershing Rd,9.2866666666666671,0.28333333333333333,11.5375,1,4,5,0,5
Public Rack - Cicero & Rosemont,20.096666666666668,8.9416666666666664,27.533333333333335,2,3,5,0,5
Public Rack - Central Ave & North Ave,6.1933333333333334,2.3666666666666667,7.15,1,4,5,0,5
Public Rack - Normal Ave & 72nd St,13.31,16.258333333333333,1.5166666666666666,4,1,5,0,5
Public Rack - Mulligan & Northwest Hwy,19.386666666666663,8.65,22.070833333333333,1,4,5,0,5
Public Rack - The Montessori School of Englewood,8.7333333333333325,7.325,14.366666666666667,4,1,5,0,5
Public Rack - Central Ave & Corcoran Pl,3.2800000000000002,3.2800000000000002,,5,0,5,0,5
Public Rack - Buffalo Ave & 133rd St,30.740000000000002,30.740000000000002,,5,0,5,0,5
Public Rack - Chappel Ave & 71st St,13.143333333333334,4.3375,48.366666666666667,4,1,5,0,5
Public Rack - Rockwell & 111th St,3.4266666666666672,8.2166666666666668,0.23333333333333334,2,3,5,0,5
Public Rack - California Ave & Touhy Ave - midblock,3.1633333333333336,13.616666666666667,0.55,1,4,5,0,5
Public Rack - Linder & 51st,6.15,8.8833333333333329,2.05,3,2,5,0,5
Public Rack - Richard Daley College,10.666666666666666,4.6958333333333337,34.55,4,1,5,0,5
Public Rack - Vincennes Ave & 95th Pl,2.7666666666666666,5.5916666666666668,0.8833333333333333,2,3,5,0,5
Nagle Ave & Belmont Ave,14.416666666666666,11.53888888888889,18.733333333333334,3,2,5,0,5
Public Rack - Montrose Ave & Lavergne Ave,7.7733333333333325,6.8277777777777775,9.1916666666666664,3,2,5,0,5
Public Rack - Harlem & Palatine,28.040000000000003,34.758333333333333,1.1666666666666667,4,1,5,0,5
Public Rack - Peterson Ave & Bernard Ave,7.9300000000000006,,7.9300000000000006,0,5,5,0,5
Public Rack - Northwest Hwy & Neva Ave,24.236666666666665,11.025,33.044444444444444,2,3,5,0,5
Oconto Ave & Belmont Ave,11.386666666666667,12.372222222222224,9.9083333333333332,3,2,3,2,5
Public Rack - Baltimore Ave & 133rd St,43.02,64.894444444444446,10.208333333333334,3,2,5,0,5
Public Rack - Western Ave & 118th St,20.706666666666667,19.308333333333334,21.638888888888889,2,3,5,0,5
South Chicago Ave & Elliot Ave,17.563333333333333,17.158333333333335,17.833333333333332,2,3,3,2,5
Public Rack - Avers Ave & Archer Ave,8.625,7.833333333333333,9.4166666666666661,2,2,4,0,4
Public Rack - Komensky Ave & 63rd St,7.5625,7.55,7.575,2,2,4,0,4
Public Rack - Homan Ave & Lake St,7.3375,,7.3375,0,4,4,0,4
Market Days Scooter Corral,8.6541666666666668,4.9083333333333332,12.4,2,2,4,0,4
Public Rack - Kedzie Ave & 64th St - SW,12.504166666666666,14.605555555555556,6.2,3,1,4,0,4
Public Rack - Central Park Ave & Ogden Ave,9.8291666666666675,,9.8291666666666675,0,4,4,0,4
Public Rack - Linder & Elston,3.35,2.3444444444444446,6.3666666666666663,3,1,4,0,4
Public Rack - Odell & Talcott,30.445833333333333,38.405555555555559,6.5666666666666664,3,1,4,0,4
Public Rack - Legler Regional Library,10.229166666666666,,10.229166666666666,0,4,4,0,4
Public Rack - Grand Ave & North Ave,7.833333333333333,23.25,2.6944444444444446,1,3,4,0,4
Public Rack - Minnehaha Ave & Devon Ave,8.2958333333333325,11.166666666666666,7.3388888888888886,1,3,4,0,4
Public Rack - Kingston Ave & 75th St,8.0333333333333332,11.466666666666667,4.6,2,2,4,0,4
Public Rack - Komensky Ave & 26th St,7.725,4.9,10.55,2,2,4,0,4
Public Rack - Kedzie & 103rd St - East,4.333333333333333,4.333333333333333,,4,0,4,0,4
Public Rack - Brighton Park Branch Chicago Library,14.7375,7.333333333333333,17.205555555555556,1,3,4,0,4
Public Rack - Elston Ave & Gunnison St,14.345833333333333,,14.345833333333333,0,4,4,0,4
Public Rack - Western Ave & 105th St,8.3833333333333329,10.31111111111111,2.6,3,1,4,0,4
Public Rack - Kedvale Ave & 26th St,20.3,7.9833333333333334,24.405555555555555,1,3,4,0,4
Damen Ave & 77th St,23.433333333333334,17.3,41.833333333333336,3,1,0,4,4
Public Rack - Maplewood Ave & 63rd St,8.2666666666666675,8.2666666666666675,,4,0,4,0,4
Public Rack - Racine Ave & 83rd St,19.920833333333334,25.227777777777774,4,3,1,4,0,4
Public Rack - McVicker & 52nd,3.7,4.3388888888888886,1.7833333333333334,3,1,4,0,4
Public Rack - Linder Ave & 64th Pl,24.779166666666665,24.779166666666665,,4,0,4,0,4
Public Rack - Rutherford Ave & Belmont Ave,2.7416666666666667,2.2277777777777774,4.2833333333333332,3,1,4,0,4
Public Rack - Colfax Ave & 83rd St,3.6166666666666667,0.8666666666666667,4.5333333333333332,1,3,4,0,4
Public Rack - Ave N & 106th St,3.8375,3.8375,,4,0,4,0,4
Spaulding Ave & 63rd St,24.725,12.638888888888889,60.983333333333334,3,1,4,0,4
Public Rack - Western Ave & 111th St - SE,4.65,1.2666666666666666,8.0333333333333332,2,2,4,0,4
Public Rack - Menard Ave & Adams Blvd,8.5416666666666661,1.3833333333333333,10.927777777777777,1,3,4,0,4
Public Rack - Mt Greenwood Library - South,34.008333333333333,34.008333333333333,,4,0,4,0,4
Public Rack - Canty Elementary School,23.291666666666668,30.9,0.46666666666666667,3,1,4,0,4
Public Rack - Halsted St & 64th St,6.775,5.05,11.95,3,1,4,0,4
Public Rack - McCormick Blvd & Devon Ave,7.4125,,7.4125,0,4,4,0,4
Public Rack - Princeton Ave & 43rd St,10.2375,17.666666666666668,7.76111111111111,1,3,4,0,4
Public Rack - Homan Ave & Roosevelt,17.779166666666665,3.6333333333333333,22.494444444444447,1,3,4,0,4
Public Rack - Newcastle Ave & Wellington Ave,13.783333333333333,26.05,1.5166666666666666,2,2,4,0,4
Public Rack - Loomis Blvd & 47th St,10.025,21.983333333333334,6.0388888888888888,1,3,4,0,4
Public Rack - W. Talcott & N. Oriole,14.325,17.2,11.45,2,2,4,0,4
Public Rack - Oak Park & Higgins,36.18333333333333,11.983333333333333,44.25,1,3,4,0,4
Public Rack - Emerald Ave & 45th St,16.304166666666667,19.541666666666668,13.066666666666666,2,2,4,0,4
Public Rack - Kedzie Ave & 61st Pl E,10.108333333333333,3.6916666666666669,16.525,2,2,4,0,4
Public Rack - Halsted St & 41st St,13.279166666666667,10.083333333333334,14.344444444444443,1,3,4,0,4
Public Rack - Halsted St & 109th St,8.8375,,8.8375,0,4,4,0,4
Public Rack - Chase Ave & Touhy Ave - NW,3.4722222222222223,,3.4722222222222223,0,3,3,0,3
Public Rack - 2302 S Pulaski Rd,5.7166666666666668,6.45,4.25,2,1,3,0,3
Public Rack - Ashland Ave & 63rd St,7.6833333333333336,7.666666666666667,7.7166666666666668,2,1,3,0,3
Public Rack - Lake Park Ave & 47th St,6.85,10.433333333333334,5.0583333333333336,1,2,3,0,3
Public Rack - Rutherford & 53rd,5.6555555555555559,6.2,5.3833333333333337,1,2,3,0,3
Public Rack - Pulaski & Ardmore,6.916666666666667,,6.916666666666667,0,3,3,0,3
Public Rack - Central Ave & Adams St,11.244444444444444,11.244444444444444,,3,0,3,0,3
"Public Rack - Senka ""Edward Duke"" Park",9.27222222222222,2.5,12.658333333333333,1,2,3,0,3
Public Rack - Western Ave & 107th Pl,11.27222222222222,13.541666666666666,6.7333333333333334,2,1,3,0,3
Public Rack - Paxton Ave & 79th St,6.96111111111111,10.983333333333333,4.95,1,2,3,0,3
Public Rack - Ada St & 79th St,15.2,,15.2,0,3,3,0,3
Public Rack - Kolin Ave & Archer Ave,8.77222222222222,,8.77222222222222,0,3,3,0,3
Public Rack - South Shore High School,3.0722222222222224,3.7,1.8166666666666667,2,1,3,0,3
Public Rack - Western Ave & 107th St,7.7111111111111112,7.7111111111111112,,3,0,3,0,3
Public Rack - Ford City Mall,31.605555555555554,15.65,63.516666666666666,2,1,3,0,3
Shields Ave & 57th St,10.55,13.483333333333333,4.6833333333333336,2,1,2,1,3
Public Rack - Halsted St & 113th St,14.4,,14.4,0,3,3,0,3
Public Rack - Indiana Ave & 111th St,6.6166666666666663,10.233333333333333,4.8083333333333336,1,2,3,0,3
Public Rack - Western Blvd & 53rd St,4.55,6.1166666666666663,1.4166666666666667,2,1,3,0,3
Public Rack - Longwood Dr & 95th St,10.91111111111111,12.466666666666667,7.8,2,1,3,0,3
Public Rack - Abbott Park,8.6222222222222236,8.6333333333333329,8.6166666666666671,1,2,3,0,3
Public Rack - Albany Ave & 63rd St,12.055555555555554,14.066666666666666,8.0333333333333332,2,1,3,0,3
Public Rack - Western Ave & 104th St - West,4.3166666666666664,0.31666666666666665,6.3166666666666664,1,2,3,0,3
Public Rack - Lorel Ave & Grand Ave,9.2888888888888879,,9.2888888888888879,0,3,3,0,3
Public Rack - Newland Ave & Diversey Ave,1.6055555555555554,0.2,2.3083333333333331,1,2,3,0,3
Public Rack - Ewing Ave & Indianapolis Ave,11.355555555555556,11.355555555555556,,3,0,3,0,3
Public Rack - Avenue J & 102nd St,4.905555555555555,4.905555555555555,,3,0,3,0,3
Public Rack - Brainerd Park,0.5,0.5,,3,0,3,0,3
Public Rack - Prairie Ave & 85th St,34.35,15.625,71.8,2,1,3,0,3
Public Rack - Nordica Ave & Addison St,6.8166666666666664,9.325,1.8,2,1,3,0,3
Public Rack - Morgan St & 87th St,1.2444444444444442,1.1666666666666667,1.4,2,1,3,0,3
Public Rack - Laporte Ave & Armitage Ave,5.0333333333333332,0.38333333333333336,7.3583333333333334,1,2,3,0,3
Public Rack - Ewing Ave & 105th St,19.716666666666665,5.25,48.65,2,1,3,0,3
Public Rack - Wilbur Wright College North,14.105555555555554,0.51666666666666672,20.9,1,2,3,0,3
Public Rack - Higgins Ave & Neva Ave,9.9722222222222232,14.675,0.56666666666666665,2,1,3,0,3
Public Rack - Devon Ave & Central Ave,15.06111111111111,41,2.0916666666666668,1,2,3,0,3
Public Rack - Harvey Ave & North Ave,4.6333333333333337,5.4916666666666663,2.9166666666666665,2,1,3,0,3
Public Rack - Leoti Ave & Central Ave (south),14.166666666666666,,14.166666666666666,0,3,3,0,3
Public Rack - Archer Park,2.1555555555555554,1.45,2.5083333333333333,1,2,3,0,3
Public Rack - Back of the Yards Park,10.677777777777777,,10.677777777777777,0,3,3,0,3
Public Rack - Neola & Northwest Hwy,21.188888888888886,,21.188888888888886,0,3,3,0,3
Public Rack - Sacramento Blvd & Washington Blvd,5.9722222222222223,,5.9722222222222223,0,3,3,0,3
Baltimore Ave & 133rd St,10.877777777777776,14.95,2.7333333333333334,2,1,3,0,3
Public Rack - Newcastle Ave & Belden Ave,5.0777777777777775,2.4166666666666665,6.4083333333333332,1,2,3,0,3
Public Rack - Ashland Ave & 71st St,4.0666666666666664,5.1333333333333337,3.5333333333333332,1,2,3,0,3
Public Rack - Yates Blvd & Exchange Ave,13.316666666666666,,13.316666666666666,0,3,3,0,3
Public Rack - Hoyne Ave & 51st St,12.46111111111111,4.35,16.516666666666666,1,2,3,0,3
Public Rack - Prairie Ave & 78th St,14.972222222222223,20.2,4.5166666666666666,2,1,3,0,3
Public Rack - Ozanam Ave & Devon Ave,13.744444444444445,16.15,12.541666666666666,1,2,3,0,3
Public Rack - 61st St & Melvina Ave,24.061111111111114,14.408333333333333,43.366666666666667,2,1,3,0,3
Public Rack - Oketo & Northwest Hwy,19.577777777777779,12.283333333333333,23.225,1,2,3,0,3
Public Rack - Oketo & Talcott,13.327777777777778,13.327777777777778,,3,0,3,0,3
Public Rack - Halsted St & 102nd St,12.361111111111111,,12.361111111111111,0,3,3,0,3
Public Rack - Harlem and W. 59th,11.625,5.6166666666666663,17.633333333333333,1,1,2,0,2
Public Rack - Troy & 71st,10.691666666666666,10.691666666666666,,2,0,2,0,2
Public Rack - Kedvale Ave & Avondale Ave,3.1333333333333333,,3.1333333333333333,0,2,2,0,2
Public Rack - Kildare Ave & 63rd St,2.9583333333333335,0.26666666666666666,5.65,1,1,2,0,2
Avers Ave & 16th St,4.7,3.7333333333333334,5.666666666666667,1,1,2,0,2
Public Rack - Fairfield Ave & 63rd St,2.9916666666666667,2.9916666666666667,,2,0,2,0,2
Mozart St & 79th St,5.5666666666666664,6.2666666666666666,4.8666666666666663,1,1,1,1,2
Public Rack - Pulaski Rd & 40th St,4.4416666666666664,6.2833333333333332,2.6,1,1,2,0,2
Public Rack - 82nd st & Kedzie Ave,6.8916666666666666,6.8916666666666666,,2,0,2,0,2
Public Rack - Western Blvd & 52nd St,4.6333333333333337,6.3666666666666663,2.9,1,1,2,0,2
Public Rack - Leoti Ave & Central Ave (north),3.675,0.56666666666666665,6.7833333333333332,1,1,2,0,2
Public Rack - Pulaski Rd & Roosevelt Rd,5.175,3.3333333333333335,7.0166666666666666,1,1,2,0,2
Public Rack - Devon Ave & Kinzua Ave,4.0583333333333336,,4.0583333333333336,0,2,2,0,2
Public Rack - Vincennes Ave & 95th St,7.8833333333333337,7.1166666666666663,8.65,1,1,2,0,2
Public Rack - Pulaski Rd & 15th St,9.3166666666666664,,9.3166666666666664,0,2,2,0,2
Public Rack - Ozman & Talcott,10.916666666666666,10.916666666666666,,2,0,2,0,2
Public Rack - Springfield Ave & 63rd St,5.8916666666666666,5.8916666666666666,,2,0,2,0,2
Public Rack - Ewing Ave & 106th St,19.133333333333333,19.133333333333333,,2,0,2,0,2
Public Rack - Martin Luther King Dr & 69th St,9.8333333333333339,11.616666666666667,8.05,1,1,2,0,2
Public Rack - Vincennes Ave & 99th St,4.575,0.8833333333333333,8.2666666666666675,1,1,2,0,2
Public Rack - Karlov Ave & 26th St,11.875,11.875,,2,0,2,0,2
Public Rack - Normal Blvd & 61st Pl,4.5333333333333332,0.33333333333333331,8.7333333333333325,1,1,2,0,2
Public Rack - Kedzie Ave & 64th St - SE,9.2666666666666675,9.2666666666666675,,2,0,2,0,2
Public Rack - Harvard Ave & 103rd St,0.10833333333333334,0.10833333333333334,,2,0,2,0,2
Public Rack - Menard Ave & Leland Ave,7.75,0.033333333333333333,15.466666666666667,1,1,2,0,2
Public Rack - Western Ave & 111th St - NW,2.1916666666666669,2.1916666666666669,,2,0,2,0,2
Public Rack - Springfield & 79th,14.3,14.3,,2,0,2,0,2
Public Rack - Washtenaw Ave & 63rd St,7.1916666666666664,0.13333333333333333,14.25,1,1,2,0,2
Public Rack - Kilbourn Ave & Fullerton Ave,1.4916666666666667,0.13333333333333333,2.85,1,1,2,0,2
Public Rack - Pulaski Rd & Grenshaw St,0.23333333333333334,0.23333333333333334,,2,0,2,0,2
Public Rack - New England Ave & Grace St,1.725,0.13333333333333333,3.3166666666666669,1,1,2,0,2
Public Rack - Neenah & Dakin,1.175,0.15,2.2,1,1,2,0,2
Public Rack - Lafayette Ave & 119th St,0.18333333333333332,0.18333333333333332,,2,0,2,0,2
Public Rack - 63rd St and Nagle Ave,2.1416666666666666,2.1416666666666666,,2,0,2,0,2
Public Rack - Vincennes Ave & 77th St,14.45,0.2,28.7,1,1,2,0,2
Public Rack - Osceola Ave & Touhy Ave,7.425,0.26666666666666666,14.583333333333334,1,1,2,0,2
Public Rack - Burnside Academy,0.375,0.375,,2,0,2,0,2
Public Rack - N Sayre Ave & W Belden Ave,1.275,0.31666666666666665,2.2333333333333334,1,1,2,0,2
Public Rack - Austin Ave & Archer Ave,12.175,24.016666666666666,0.33333333333333331,1,1,2,0,2
Public Rack - Hiawatha Park,1.075,0.43333333333333335,1.7166666666666666,1,1,2,0,2
Public Rack - Menard Ave & Agusta Blvd,7.041666666666667,0.51666666666666672,13.566666666666666,1,1,2,0,2
Public Rack - Ashland Ave & 45th St  S,0.6166666666666667,,0.6166666666666667,0,2,2,0,2
Public Rack - Linder Ave & 51st St,2.75,,2.75,0,2,2,0,2
Public Rack - Kedzie Ave & 54th Pl,11.1,0.6166666666666667,21.583333333333332,1,1,2,0,2
Public Rack - Devon Ave & Minnehaha Ave (east),19.866666666666667,,19.866666666666667,0,2,2,0,2
Public Rack - Sacramento Ave & Greenleaf Ave,1.9833333333333334,,1.9833333333333334,0,2,2,0,2
Public Rack - Kedvale Ave & Addison St,2.9083333333333332,5.15,0.66666666666666663,1,1,2,0,2
Public Rack - Pittsburgh Ave & Irving Park,0.925,0.7,1.15,1,1,2,0,2
Public Rack - Al Raby School,1.9833333333333334,,1.9833333333333334,0,2,2,0,2
Public Rack - Cottage Grove Ave & 92nd St,30.525,,30.525,0,2,2,0,2
Public Rack - Pulaski Rd & 41st,11.625,,11.625,0,2,2,0,2
Public Rack - Mason Ave & Roosevelt Rd,25.841666666666665,25.841666666666665,,2,0,2,0,2
Public Rack - Ashland Ave & 45th St,6.175,,6.175,0,2,2,0,2
Public Rack - Harlem & Summerdale,9.1583333333333332,,9.1583333333333332,0,2,2,0,2
Public Rack - Throop St & 48t ST,1.7666666666666666,,1.7666666666666666,0,2,2,0,2
Public Rack - Nordica Ave & Higgins Ave,7.4416666666666664,13.566666666666666,1.3166666666666667,1,1,2,0,2
Public Rack - Kedzie Ave & Arthington St,2.2916666666666665,3.25,1.3333333333333333,1,1,2,0,2
Public Rack - Kostner & 83rd,25.966666666666665,25.966666666666665,,2,0,2,0,2
Public Rack - Oak Park Ave & Foster Ave,8.0916666666666668,14.7,1.4833333333333334,1,1,2,0,2
Public Rack - Northwest Hwy & Raven St,9.5083333333333329,,9.5083333333333329,0,2,2,0,2
Public Rack - Independence Blvd & Roosevelt,37.19166666666667,72.4,1.9833333333333334,1,1,2,0,2
Public Rack - Harriet E Sayre Public School,3.2833333333333332,4.55,2.0166666666666666,1,1,2,0,2
Public Rack - Exchange Ave & 73rd Pl,13.741666666666667,,13.741666666666667,0,2,2,0,2
Public Rack - Calumet Ave & 71st St,2.5,,2.5,0,2,2,0,2
Public Rack - Calumet Ave & Garfield Blvd,14.683333333333334,26.583333333333332,2.7833333333333332,1,1,2,0,2
Vincennes Ave & 79th St,6.9916666666666663,6.9916666666666663,,2,0,2,0,2
Public Rack - Pulaski Rd & 5th Ave,4.1333333333333337,5.3833333333333337,2.8833333333333333,1,1,2,0,2
Public Rack - Vincennes Ave & 87th St,17.791666666666668,,17.791666666666668,0,2,2,0,2
Public Rack - Stony Is Ave & 73rd St,9.2916666666666661,,9.2916666666666661,0,2,2,0,2
Public Rack - Hamilton Park,3.3416666666666668,,3.3416666666666668,0,2,2,0,2
Public Rack - Kildare Ave & Division Ave,6.3083333333333336,9.4333333333333336,3.1833333333333331,1,1,2,0,2
Public Rack - Cottage Grove Ave & 87th St,9.0416666666666661,3.45,14.633333333333333,1,1,2,0,2
Public Rack - Kenneth Ave & 63rd St W,42.575,42.575,,2,0,2,0,2
Public Rack - William J Onahan Public School,29.833333333333332,56.2,3.4666666666666668,1,1,2,0,2
Lavergne Ave & 44th St,6.525,,6.525,0,2,2,0,2
Public Rack - Leland Ave & Melvina Ave,10.208333333333334,16.483333333333334,3.9333333333333331,1,1,2,0,2
Public Rack - Damen & 87th,10.316666666666666,4.0166666666666666,16.616666666666667,1,1,2,0,2
Public Rack - Ashland Ave & 83rd St,14.283333333333333,,14.283333333333333,0,2,2,0,2
Public Rack - Damen & 81st,7.75,,7.75,0,2,2,0,2
Commercial Ave & 90th St,20.908333333333335,25.5,16.316666666666666,1,1,1,1,2
Public Rack - Pullman - Planet Fitness,15.391666666666667,14.016666666666667,16.766666666666666,1,1,2,0,2
Public Rack - Spaulding Ave & 71st St,36.55833333333333,54.583333333333336,18.533333333333335,1,1,2,0,2
Public Rack - Kostner Ave & Lake St,21.7,19.2,24.2,1,1,2,0,2
Public Rack - Ewing Ave & 95th St,19.75,20.2,19.3,1,1,2,0,2
Public Rack - Yates Ave & 100th St,16.433333333333334,,16.433333333333334,0,2,2,0,2
Public Rack - Austin & 62nd,21.466666666666665,21.466666666666665,,2,0,2,0,2
Public Rack - Lake Shore Dr & Hayes Dr,28.658333333333335,,28.658333333333335,0,2,2,0,2
Public Rack - Oglesby Ave & 95th St,17.441666666666666,17.441666666666666,,2,0,2,0,2
Public Rack - Kenneth Ave & 63rd St E,17.208333333333332,17.208333333333332,,2,0,2,0,2
Public Rack - Mason Ave & Milwaukee Ave,20.55,31.816666666666666,9.2833333333333332,1,1,2,0,2
Public Rack - Michigan Ave & 67th St,26.391666666666666,26.391666666666666,,2,0,2,0,2
Public Rack - Pulaski & 52nd,11.733333333333333,14.166666666666666,9.3,1,1,2,0,2
Public Rack - Ottowa Ave & Touhy Ave,10.6,10.6,,2,0,2,0,2
Public Rack - Wentworth Ave & 103rd St,11.233333333333333,11.233333333333333,,2,0,2,0,2
Public Rack - Perry Ave & 111th St,12.816666666666666,12.6,13.033333333333333,1,1,2,0,2
Public Rack - Brooks Park,13.783333333333333,13.566666666666666,14,1,1,2,0,2
Public Rack - Calumet Ave & 103rd St,5.45,5.45,,1,0,1,0,1
Public Rack - Crandon Ave & 80th St,5.7666666666666666,5.7666666666666666,,1,0,1,0,1
Public Rack - Western Ave & 62nd St,5.916666666666667,5.916666666666667,,1,0,1,0,1
Public Rack - Cottage Grove Ave & 98th St,5.9666666666666668,5.9666666666666668,,1,0,1,0,1
Public Rack - Cottage Grove Ave & 91st St,6.2833333333333332,,6.2833333333333332,0,1,1,0,1
Public Rack - May St & 63rd St,6.6166666666666663,6.6166666666666663,,1,0,1,0,1
Public Rack - Walden Pkwy & 99th St,6.6333333333333337,6.6333333333333337,,1,0,1,0,1
Public Rack - Wabash Ave & 87th St,6.666666666666667,6.666666666666667,,1,0,1,0,1
Public Rack - St Louis & Columbus,6.7166666666666668,6.7166666666666668,,1,0,1,0,1
Public Rack - Homan & 79th,7.0666666666666664,7.0666666666666664,,1,0,1,0,1
Public Rack - Troy & 111th St,7.1166666666666663,7.1166666666666663,,1,0,1,0,1
Public Rack - Pullman - Walmart,7.2833333333333332,7.2833333333333332,,1,0,1,0,1
Public Rack - 53rd St & Indiana Ave,7.5666666666666664,,7.5666666666666664,0,1,1,0,1
Public Rack - Eggleston Ave & 115th St,7.85,7.85,,1,0,1,0,1
Public Rack - Princeton Ave & 99th Pl,7.8666666666666663,7.8666666666666663,,1,0,1,0,1
Public Rack - Cottage Grove Ave & 75th St,7.9833333333333334,,7.9833333333333334,0,1,1,0,1
Public Rack - Ingleside Ave & 79th St,8.3,8.3,,1,0,1,0,1
Public Rack - King Dr & 83rd St,8.4333333333333336,,8.4333333333333336,0,1,1,0,1
Public Rack - Mackinaw Ave & 108th St,8.5666666666666664,8.5666666666666664,,1,0,1,0,1
Public Rack - California & 87th,8.5666666666666664,8.5666666666666664,,1,0,1,0,1
Public Rack - Plainfield Ave & Irving Park Rd,8.6333333333333329,,8.6333333333333329,0,1,1,0,1
Public Rack - Octavia Ave & Touhy Ave,0.13333333333333333,0.13333333333333333,,1,0,1,0,1
Public Rack - S Kostner Ave & W 18th Pl,0.21666666666666667,0.21666666666666667,,1,0,1,0,1
Public Rack - Kostner Ave & 16th St,0.23333333333333334,0.23333333333333334,,1,0,1,0,1
Public Rack - Pulaski Rd & Lexington St,0.26666666666666666,0.26666666666666666,,1,0,1,0,1
Public Rack - Christiana Ave & 55th St,0.36666666666666664,0.36666666666666664,,1,0,1,0,1
Public Rack - East End Ave & 75th St,0.36666666666666664,0.36666666666666664,,1,0,1,0,1
Public Rack - Lawndale Ave & 63rd St,0.38333333333333336,0.38333333333333336,,1,0,1,0,1
Public Rack - 83rd St (Avalon Park) Metra,0.45,0.45,,1,0,1,0,1
Public Rack - Lawndale Ave & Roosevelt,0.51666666666666672,,0.51666666666666672,0,1,1,0,1
Public Rack - La Moyne Ave and Leamington Ave,0.55,,0.55,0,1,1,0,1
Public Rack - Piotrowski Park,0.55,0.55,,1,0,1,0,1
Public Rack - Marshfield Ave & 45th St,0.68333333333333335,,0.68333333333333335,0,1,1,0,1
Public Rack - Devon Ave & Minnehaha Ave (west),0.78333333333333333,0.78333333333333333,,1,0,1,0,1
Public Rack - Cicero Ave & Le Moyne St - midblock,0.91666666666666663,,0.91666666666666663,0,1,1,0,1
Public Rack - Panama Ave & Forest Preserve Ave,0.93333333333333335,,0.93333333333333335,0,1,1,0,1
Public Rack - Western Ave & 79th St,0.96666666666666667,,0.96666666666666667,0,1,1,0,1
Public Rack - Western Ave & 106th St - West,0.96666666666666667,0.96666666666666667,,1,0,1,0,1
Public Rack - Ashland Ave & 46th St,1.0833333333333333,,1.0833333333333333,0,1,1,0,1
Public Rack - 63rd & Western Ave N,1.0833333333333333,,1.0833333333333333,0,1,1,0,1
Public Rack - Sangamon St & 87th St,1.1833333333333333,,1.1833333333333333,0,1,1,0,1
Hamilton Park,1.2833333333333334,,1.2833333333333334,0,1,1,0,1
Public Rack - Roscoe St & Osceola Ave,1.3166666666666667,,1.3166666666666667,0,1,1,0,1
Public Rack - Central Ave & Congress Pkwy,1.5333333333333334,,1.5333333333333334,0,1,1,0,1
Public Rack - Kedzie Ave & 62nd Pl,1.5833333333333333,,1.5833333333333333,0,1,1,0,1
Public Rack - Oleander Ave & Addison St,1.65,,1.65,0,1,1,0,1
Public Rack - Mason & Archer,1.7333333333333334,,1.7333333333333334,0,1,1,0,1
Public Rack - Honore St & 87th St,1.7833333333333334,,1.7833333333333334,0,1,1,0,1
Public Rack - Lamon Ave & Erie St,1.8333333333333333,,1.8333333333333333,0,1,1,0,1
Public Rack - Aida Food Market,1.8333333333333333,,1.8333333333333333,0,1,1,0,1
Public Rack - Newcastle Ave & Belmont Ave,2,,2,0,1,1,0,1
Public Rack - May St & 87th St,2.1666666666666665,,2.1666666666666665,0,1,1,0,1
Public Rack - Damen Ave & 84th St,2.1833333333333331,,2.1833333333333331,0,1,1,0,1
Public Rack - Racine Ave & 76th,2.2,,2.2,0,1,1,0,1
Public Rack - Sangamon St & 79th St,2.2166666666666668,,2.2166666666666668,0,1,1,0,1
Public Rack - Jeffery Blvd & 81st St,2.35,,2.35,0,1,1,0,1
Public Rack - Marshfield Ave & 87th St,2.4833333333333334,,2.4833333333333334,0,1,1,0,1
Public Rack - McVicker Ave & Grand Ave,2.5333333333333332,,2.5333333333333332,0,1,1,0,1
Public Rack - Cottage Grove Ave & 111th St,2.6666666666666665,,2.6666666666666665,0,1,1,0,1
Public Rack - Mason Ave & Archer Ave,2.7833333333333332,,2.7833333333333332,0,1,1,0,1
Public Rack - Horner & 85th,2.7833333333333332,,2.7833333333333332,0,1,1,0,1
Public Rack - Baltimore Ave & 132nd St,2.8333333333333335,2.8333333333333335,,1,0,1,0,1
Newcastle Ave & Irving Park Rd,2.8666666666666667,,2.8666666666666667,0,1,1,0,1
Public Rack - Lotus Ave & Harrison St,2.8833333333333333,,2.8833333333333333,0,1,1,0,1
Public Rack - Hamlin Ave & Chicago Ave,2.9,,2.9,0,1,1,0,1
Public Rack - Ewing Ave & 106th St NW,3.1166666666666667,,3.1166666666666667,0,1,1,0,1
Public Rack - Oakley Ave & 50th Pl,3.15,,3.15,0,1,1,0,1
Public Rack - Lawndale & 63rd St,3.25,3.25,,1,0,1,0,1
Public Rack - Justine St & 87th St,3.4,,3.4,0,1,1,0,1
Public Rack - Loomis St & 87th St,3.4333333333333331,,3.4333333333333331,0,1,1,0,1
Public Rack - Peoria St & 60th St,3.5166666666666666,,3.5166666666666666,0,1,1,0,1
Public Rack - Halsted St & 77th St,3.6166666666666667,,3.6166666666666667,0,1,1,0,1
Public Rack - Western & 79th,3.6333333333333333,,3.6333333333333333,0,1,1,0,1
Oketo Ave & Addison,3.8333333333333335,3.8333333333333335,,1,0,1,0,1
Public Rack - Artesian & 71st,3.9833333333333334,,3.9833333333333334,0,1,1,0,1
Public Rack - Marquette Ave & 79th St,4.2,,4.2,0,1,1,0,1
Public Rack - May St & 78th St,4.35,,4.35,0,1,1,0,1
Public Rack - Keeler Ave & 55th St,4.3666666666666663,4.3666666666666663,,1,0,1,0,1
Public Rack - Laflin St & 79th St,4.6166666666666663,,4.6166666666666663,0,1,1,0,1
Public Rack - Northwest Hwy & Highland Ave,4.6833333333333336,4.6833333333333336,,1,0,1,0,1
Public Rack - Michigan Ave & 110th St,4.85,4.85,,1,0,1,0,1
Public Rack - Keef Ave & South Chicago Ave,5.3833333333333337,,5.3833333333333337,0,1,1,0,1
Public Rack - Miami Ave & Milwaukee Ave,18.033333333333335,,18.033333333333335,0,1,1,0,1
Public Rack - Tuley (Murray) Park,19.933333333333334,,19.933333333333334,0,1,1,0,1
Public Rack - S. New England/ W. 65th,20.133333333333333,,20.133333333333333,0,1,1,0,1
Public Rack - Commercial Ave & 89th St,20.283333333333335,,20.283333333333335,0,1,1,0,1
Public Rack - Wolcott Ave & 56th St,20.983333333333334,20.983333333333334,,1,0,1,0,1
Public Rack - Sacramento & 71st,21.25,,21.25,0,1,1,0,1
Public Rack - Keeler Ave & Madison St S,24.933333333333334,,24.933333333333334,0,1,1,0,1
Martin Luther King Dr & 87th St,25.533333333333335,25.533333333333335,,1,0,1,0,1
Public Rack - 10101 S Stony Island Ave,29.066666666666666,29.066666666666666,,1,0,1,0,1
Public Rack - Michigan Ave & 119th St,29.9,29.9,,1,0,1,0,1
Public Rack - Houston Ave & 91st St,29.916666666666668,,29.916666666666668,0,1,1,0,1
Public Rack - Pulaski Rd & 83rd St,35.55,,35.55,0,1,1,0,1
Public Rack - Austin Branch Chicago Public Library,37.06666666666667,,37.06666666666667,0,1,1,0,1
Public Rack - Lake Park Ave & 44th St,40.133333333333333,,40.133333333333333,0,1,1,0,1
Public Rack - Cornell Ave & 87th Pl,41.05,41.05,,1,0,1,0,1
Overhill Ave & Belmont Ave,50.216666666666669,50.216666666666669,,1,0,1,0,1
Burley Ave & 91st St,52.083333333333336,,52.083333333333336,0,1,0,1,1
Public Rack - Parnell Ave & 98th St,52.783333333333331,52.783333333333331,,1,0,1,0,1
Public Rack - Pulaski & 84th,75.4,,75.4,0,1,1,0,1
Public Rack - Kedzie & 73rd,101.08333333333333,101.08333333333333,,1,0,1,0,1
Homan Ave & Arthington Ave,9.3333333333333339,9.3333333333333339,,1,0,1,0,1
Public Rack - Torrence Ave & 98th St,9.7166666666666668,9.7166666666666668,,1,0,1,0,1
Public Rack - Hale Ave & 111th St,10.3,,10.3,0,1,1,0,1
Public Rack - East End Ave & 87th St,10.416666666666666,10.416666666666666,,1,0,1,0,1
Public Rack - Cottage Grove & 85th St,10.85,,10.85,0,1,1,0,1
Public Rack - Ada St & 119th St,12.016666666666667,,12.016666666666667,0,1,1,0,1
Spaulding Ave & 16th,12.1,12.1,,1,0,1,0,1
Mason Ave & Montrose Ave,12.366666666666667,12.366666666666667,,1,0,0,1,1
Public Rack - St Louis & 83rd,13.983333333333333,13.983333333333333,,1,0,1,0,1
Public Rack - Torrence Ave  & 106th St,14.566666666666666,,14.566666666666666,0,1,1,0,1
Public Rack - Springfield & 71st,15.066666666666666,15.066666666666666,,1,0,1,0,1
Public Rack - Cottage Grove & 84th St,15.116666666666667,15.116666666666667,,1,0,1,0,1
Public Rack - Kedzie & 71st,15.35,,15.35,0,1,1,0,1
